State,District,Latitude,Longitude,District code,Population,Male,Female,Literate,Households_with_Internet,Households_with_Computer,Rural_Households,Urban_Households,Households,Below_Primary_Education,Primary_Education,Middle_Education,Secondary_Education,Higher_Education,Graduate_Education,Other_Education,Literate_Education,Illiterate_Education,sex_ratio,literacy_rate
Andhra Pradesh,Anantapur,14.312065561843148,77.46015844785771,553,4081148,2064495,2016653,2310960,8606,48299,902997,341431,1244428,462273,720357,582075,331793,162175,144915,23341,2426929,1369069,97.68262940816035,56.62524368143473
Andhra Pradesh,Chittoor,13.33109263067696,78.92763898886038,554,4174064,2090204,2083860,2667878,13763,67087,907970,395900,1303870,522961,770836,673197,548336,265199,246409,36017,3062955,1170993,99.69648895514504,63.915598802509976
Andhra Pradesh,East Godavari,16.782718320784902,82.2432074720511,545,5154296,2569688,2584608,3288577,22411,93784,1199479,406362,1605841,669420,947606,797497,521562,271809,263023,47702,3518619,1524603,100.58061523422299,63.80264152466215
Andhra Pradesh,Guntur,15.884925767634847,80.58657614107885,548,4887813,2440521,2447292,2960441,19383,80434,1069877,513113,1582990,736270,845810,674957,453446,246580,221924,30279,3209266,1474349,100.27744075957553,60.56780404651324
Andhra Pradesh,Krishna,16.143872753151673,81.14805061000413,547,4517398,2267375,2250023,3009718,30438,101450,909292,567042,1476334,618101,692968,630603,531821,312753,328454,54728,3169428,1352499,99.2347097414411,66.62503503122815
Andhra Pradesh,Kurnool,15.437597151424288,77.90086836581717,552,4053463,2039227,2014236,2127161,10081,56478,783853,306982,1090835,521327,672951,466940,271828,152453,115504,19282,2220285,1517933,98.77448660693489,52.47762222080231
Andhra Pradesh,Prakasam,15.489039001601704,80.11665790176184,549,3397448,1714764,1682684,1904435,6151,43611,873486,214089,1087575,489805,495556,368919,249034,142026,133627,21976,1900943,1218310,98.12918862304085,56.054868242280676
Andhra Pradesh,Srikakulam,18.570900998697432,84.25874814010676,542,2703114,1341738,1361376,1495381,3988,32280,752752,149684,902436,291793,348354,319244,251521,146721,121213,21031,1499877,1009992,101.46362404582715,55.32067829917643
Andhra Pradesh,Vizianagaram,18.28329696032972,83.45982854198874,543,2344474,1161477,1182997,1238388,4453,24128,592458,157056,749514,250446,300057,257468,186576,115144,103591,27041,1240323,1031683,101.85281327137774,52.82157106455435
Andhra Pradesh,West Godavari,16.63297943925236,81.45912990654196,546,3936966,1964918,1972048,2652389,12050,55613,1007255,248373,1255628,595331,718960,585595,415178,215863,207586,33329,2771842,1028767,100.36286501523219,67.37139716218022
Arunachal Pradesh,Changlang,27.360484793388448,96.37552644628109,253,148226,76948,71278,73174,170,1486,33422,6498,39920,20425,22537,17354,10032,5641,3633,834,80456,57290,92.63138743047253,49.3665079000985
Arunachal Pradesh,East Kameng,27.371194055944056,93.04741486013997,247,78690,38775,39915,38449,57,885,14503,5215,19718,11713,10487,8852,6213,4510,2330,142,44247,31763,102.94003868471953,48.861354682933026
Arunachal Pradesh,East Siang,28.15382352941176,95.06499226006191,251,99214,50116,49098,62576,450,1582,19497,9524,29021,9938,13713,13968,10937,9498,6540,525,65119,21543,97.96871258679862,63.07174390710988
Arunachal Pradesh,Kurung Kumey,28.04853351800553,93.24531994459836,256,92076,45318,46758,36606,95,969,18603,1092,19695,12661,15054,12264,6997,4353,2031,299,53659,42621,103.17754534622003,39.756288283591815
Arunachal Pradesh,Lohit,27.946785273972623,96.59670770547945,259,145726,76221,69505,83062,312,1471,33599,11372,44971,19306,25179,20643,13070,7612,5180,584,91574,52421,91.1887799950145,56.998751080795465
Arunachal Pradesh,Lower Dibang Valley,28.32651730103806,95.76567335640142,258,54080,28053,26027,31849,207,742,12000,3950,15950,5875,7957,7351,5508,3570,2795,85,33141,14406,92.77795601183473,58.89238165680474
Arunachal Pradesh,Lower Subansiri,27.70849297297297,93.96226108108112,255,83030,41843,41187,54057,381,1598,18112,5365,23477,8492,10821,11661,9861,7674,5230,295,54034,17273,98.43223478240088,65.1053835962905
Arunachal Pradesh,Papum Pare,27.27352971698113,93.54468183962264,248,176573,89182,87391,121048,2477,7418,20308,30180,50488,15368,21956,21376,20007,17342,13840,926,110815,30360,97.99174721356327,68.55408244748631
Arunachal Pradesh,Tawang,27.680683962264148,91.82504245283016,245,49977,29151,20826,26073,96,494,10730,2452,13182,4904,4730,4029,2140,1989,1379,667,19838,19203,71.44180302562519,52.169998199171616
Arunachal Pradesh,Tirap,26.944062295081984,95.41470327868862,254,111975,57604,54371,47974,98,888,18420,6500,24920,13585,16989,12077,7834,4305,2134,182,57106,50628,94.38754253176863,42.843491850859564
Arunachal Pradesh,Upper Siang,28.8309244897959,95.00155765306124,252,35320,18699,16621,18195,97,392,8569,2182,10751,3952,5584,4915,2935,2211,1349,46,20992,11209,88.88710626236697,51.514722536806346
Arunachal Pradesh,Upper Subansiri,28.277196566523585,93.8991435622318,249,83448,41758,41690,45278,139,750,14542,4672,19214,10219,16118,15339,10348,8017,4276,473,64790,28364,99.8371569519613,54.25893969897421
Arunachal Pradesh,West Kameng,27.46486582278483,92.65015750452083,246,83947,46155,37792,48492,202,887,17889,6306,24195,8836,10317,8428,5633,3987,2693,299,40193,25606,81.8806196511754,57.76501840446948
Arunachal Pradesh,West Siang,28.106296920289846,94.53510344202908,250,112274,58168,54106,64746,303,1300,22272,8503,30775,14227,17675,15908,11441,8418,6030,521,74220,27956,93.01677898500894,57.66784829969539
Assam,Barpeta,26.427872264631056,90.97912010178116,303,1693622,867004,826618,897058,2078,25286,447189,52192,499381,210607,307884,300845,121924,87377,46947,8007,1083591,664161,95.3418900028143,52.9668367557814
Assam,Bongaigaon,26.45012521994133,90.6734296187684,319,738804,375818,362986,434078,2523,12959,181923,38470,220393,93591,138294,133643,55924,35491,20221,2267,479431,260721,96.58558131861699,58.75414859692151
Assam,Cachar,24.815570668693017,92.86849650455927,316,1736617,886284,850333,1174128,5316,37541,346227,88933,435160,256855,447993,379469,156156,79766,45341,12951,1378531,357907,95.94362529392384,67.61007176596797
Assam,Darrang,26.584632159624423,92.04141338028155,325,928500,475273,453227,487039,1166,12084,268517,20189,288706,119027,163277,161153,59039,47398,22267,3079,575240,375556,95.36140281480328,52.4543887991384
Assam,Dhemaji,27.58653343848582,94.71336908517353,308,686133,351249,334884,423028,1192,10410,211758,16504,228262,79107,138838,136371,80804,55399,28006,2868,521393,194984,95.34091200259644,61.65393589872517
Assam,Dibrugarh,27.30612284482757,95.0998282327587,310,1326335,676434,649901,884531,8817,34479,299852,77163,377015,143189,243607,301287,139813,89500,59380,6984,983760,340744,96.07751827968436,66.68986342062902
Assam,Goalpara,26.01727777777781,90.59869891598912,302,1008183,513292,494891,563577,1364,13524,228610,39504,268114,124700,213510,183904,73683,39885,18294,3464,657440,375071,96.4151009561809,55.90026810608788
Assam,Golaghat,26.377219709794485,93.8258339782347,313,1066888,543161,523727,721764,3073,17636,292893,34190,327083,117393,223902,261192,111145,66197,36887,4084,820800,258897,96.42205533902471,67.6513373475004
Assam,Hailakandi,24.45749608938549,92.59154664804475,318,659296,337890,321406,407366,1211,10615,159215,16202,175417,88596,177984,139029,50056,28504,11608,4265,500042,173306,95.12148924206103,61.78802844245984
Assam,Jorhat,26.76244824016563,94.30197722567289,312,1092256,556805,535451,794929,5651,26357,286330,80824,367154,99454,201680,295444,128050,97025,62608,8433,892694,209170,96.16490512836631,72.7786343128351
Assam,Kamrup,26.17093945205481,91.58863273972592,321,1517542,778461,739081,995319,3109,23468,390596,43849,434445,163849,290097,353861,154831,118849,55011,6444,1142942,392678,94.94130084872589,65.58757517090137
Assam,Karbi Anglong,26.08966454598031,93.11536570271832,314,956313,490167,466146,557214,1923,11340,215691,37185,252876,109324,212224,199289,93137,40602,18225,3426,676227,310093,95.09942529790867,58.26690633715113
Assam,Karimganj,24.69660712250711,92.3679498575498,317,1228686,625864,602822,795297,1933,24699,261945,32695,294640,198059,333885,257931,76685,39637,21408,7903,935508,303785,96.31836948602253,64.72744053403392
Assam,Kokrajhar,26.49724663573087,90.13997470997688,300,887142,452905,434237,489305,1218,14063,204896,17115,222011,116899,166013,154715,78788,39571,17287,2733,576006,340601,95.87816429494043,55.15520626912039
Assam,Lakhimpur,27.14128805970149,94.0775949253732,307,1042137,529674,512463,683486,1948,15011,293239,34694,327933,126950,212080,217497,107326,82885,44212,4731,795681,275677,96.7506428482425,65.58504304136596
Assam,Nagaon,26.264621706263515,92.9306191144708,305,2823768,1439112,1384656,1710716,5121,45956,674999,124186,799185,392616,638088,576214,199792,115864,66994,10351,1999919,873197,96.21599986658438,60.582739091880065
Assam,Nalbari,26.46323767605632,91.40598521126763,323,771639,396006,375633,531771,1631,12360,210706,28238,238944,75866,141690,192771,81507,71734,39368,3693,606629,188960,94.85538097907607,68.91447943921963
Assam,Sonitpur,26.73514926829268,92.85197804878044,306,1924110,983904,940206,1108572,4358,31254,483325,64528,547853,216097,416218,377653,141373,90385,49901,6412,1298039,627141,95.55871304517514,57.614793333021495
Assam,Tinsukia,27.535492911392414,95.69055949367085,309,1327929,680231,647698,798322,5135,27948,290704,90910,381614,150893,266717,276292,109805,61040,38152,7353,910252,417081,95.2173599850639,60.11782256430879
Bihar,Araria,26.21152811918061,87.30766554934816,209,2811569,1463333,1348236,1195768,2561,29796,659061,44213,703274,625357,426625,206161,112955,68177,39627,6938,1485840,1653766,92.13459957507963,42.530274021373835
Bihar,Aurangabad,24.774291867469877,84.45986024096379,235,2540073,1318684,1221389,1466002,2362,31168,428291,49006,477297,559512,482199,302662,253142,136783,91371,8329,1833998,784131,92.6218108356513,57.71495543632014
Bihar,Aurangabad,24.774291867469877,84.45986024096379,515,3701282,1924469,1776813,2503837,23258,69937,551789,427343,979132,381695,686271,422964,537936,310762,253253,19101,2611982,819734,92.32744201127687,67.64783121091557
Maharashtra,Aurangabad,20.0979228832952,75.32072196796334,235,2540073,1318684,1221389,1466002,2362,31168,428291,49006,477297,559512,482199,302662,253142,136783,91371,8329,1833998,784131,92.6218108356513,57.71495543632014
Maharashtra,Aurangabad,20.0979228832952,75.32072196796334,515,3701282,1924469,1776813,2503837,23258,69937,551789,427343,979132,381695,686271,422964,537936,310762,253253,19101,2611982,819734,92.32744201127687,67.64783121091557
Bihar,Banka,24.83235564202333,86.8664916342413,225,2034763,1067140,967623,965321,1704,22300,425604,18492,444096,408188,386707,196305,120653,63103,35767,3922,1214645,879831,90.67441947635737,47.44144649770023
Bihar,Begusarai,25.54302613168723,86.1256014403293,222,2970541,1567660,1402881,1548673,4644,43127,594377,139248,733625,577601,484502,291877,207136,144783,101836,14599,1822334,1242551,89.4888560019392,52.13437552284247
Bihar,Bhagalpur,25.27719288537548,87.04213814229243,224,3037766,1615663,1422103,1573066,6764,46929,522527,130634,653161,614644,524322,300767,247079,154643,118843,16119,1976417,1139715,88.01977887715445,51.78364627163514
Bihar,Bhojpur,25.50666439393939,84.49407803030304,231,2728407,1430380,1298027,1599151,3661,34658,434559,77368,511927,581580,605307,367059,313509,163303,131137,10630,2172525,1005140,90.74700429256562,58.61116028510409
Bihar,Buxar,25.48593018867924,84.08808081760995,232,1706352,887977,818375,989807,1784,19324,299252,35405,334657,331675,420187,256124,178044,89306,64117,5224,1344677,457814,92.16173391878392,58.00719898356259
Bihar,Darbhanga,26.14618771929825,85.97387352472099,215,3937385,2059949,1877436,1816634,6280,53205,907174,95539,1002713,672797,490534,332382,224622,152540,129597,26073,2028545,2203198,91.13992627972829,46.138084032930486
Bihar,Gaya,24.726654154727804,84.94291217765044,236,4391418,2266566,2124852,2297613,6856,57011,696289,111282,807571,902272,757690,447480,342254,191824,131163,12047,2784730,1953368,93.74763408610207,52.32052608064184
Bihar,Gopalganj,26.448743641618517,84.34636127167629,217,2562012,1267666,1294346,1382998,3707,33596,515925,38133,554058,540603,470828,291624,223776,123249,79109,7690,1736879,977719,102.10465532719186,53.98093373489273
Bihar,Jamui,24.78418380462726,86.26316298200514,238,1760405,916064,844341,858588,1839,22414,325909,30851,356760,420472,317612,153973,104211,56137,29633,3439,1085477,765297,92.17052520347923,48.77218594584769
Bihar,Jehanabad,25.15567904564316,84.9208124481328,239,1125313,585582,539731,618881,1106,11302,186660,28132,214792,211761,165906,117558,112966,68748,45519,3539,725997,495877,92.17001205638151,54.99634323961422
Bihar,Katihar,25.565653560371512,87.70466083591326,212,3071029,1600430,1470599,1280190,2941,27263,668232,69838,738070,472616,444260,237243,133811,88498,57114,11896,1445438,1705551,91.88774266915767,41.68602771253544
Bihar,Khagaria,25.53558891454964,86.56593256351037,223,1666886,883786,783100,768028,1580,21654,373696,21007,394703,350601,233494,130004,100555,65931,38697,5969,925251,903323,88.6074230639544,46.07561644887533
Bihar,Kishanganj,26.32433675832129,87.95045007235886,210,1690400,866970,823430,745056,1093,14073,401793,43357,445150,356401,235779,89025,42778,25989,15386,3761,769119,945397,94.97791157710186,44.07572172266919
Bihar,Lakhisarai,25.183449321266966,86.1282570135747,227,1000912,526345,474567,507270,1186,8862,175882,31763,207645,172076,149312,111684,85807,48001,27261,3814,597955,450967,90.16272596870874,50.68077912943396
Bihar,Madhepura,25.77341929460581,86.8978443983403,213,2001762,1047559,954203,834577,1397,23309,486278,24000,510278,340813,189431,114474,99437,79891,44955,6509,875510,1202278,91.0882346483587,41.692119242946966
Bihar,Madhubani,26.41380538172716,86.16328360450552,207,4487379,2329313,2158066,2155338,5319,65548,1047552,41234,1088786,783888,771417,520875,303114,170563,137780,11352,2698989,2003079,92.6481756638116,48.03111125670464
Bihar,Munger,25.19853796296297,86.54173672839504,226,1367765,729041,638724,801817,2653,17946,222281,85782,308063,226699,158699,146414,147152,101907,64469,4394,849734,498676,87.61153350771768,58.62242417374329
Bihar,Muzaffarpur,26.186644171779147,85.32745092024544,216,4801062,2527497,2273565,2509232,10290,73012,998694,120700,1119394,1092952,743623,419433,299475,194920,138916,14475,2903794,1924438,89.95322249640653,52.264103233826184
Bihar,Nalanda,25.229345508982053,85.48053113772461,229,2877653,1497060,1380593,1519933,4156,43848,514141,102522,616663,581978,486266,320839,274556,177358,133032,11159,1985188,1324385,92.22028509211387,52.818494794195125
Bihar,Nawada,24.825708836206907,85.61594568965519,237,2219146,1144668,1074478,1091012,1841,28411,379551,45323,424874,601011,368649,195072,161127,95943,64585,3130,1489517,1091439,93.86809100979498,49.163597167559054
Bihar,Patna,25.40297114503818,85.31984335877871,230,5838465,3078512,2759953,3459679,40692,132582,657991,552103,1210094,1244842,1095655,920051,698351,463361,452340,46126,4920726,2590473,89.65217611625357,59.25665393215511
Bihar,Purnia,25.81714801901739,87.40447606973066,211,3264619,1699370,1565249,1332326,4170,33664,712847,85749,798596,668690,360243,184327,119259,83226,59996,11116,1486857,1798786,92.10760458287483,40.81107167482637
Bihar,Rohtas,24.99170460829495,83.93507626728109,234,2959918,1543546,1416372,1799832,4594,36279,512383,95678,608061,535187,548971,399053,333053,194928,161555,16006,2188753,876443,91.7609193376809,60.806819648382145
Bihar,Saharsa,25.821270696721307,86.54670819672134,214,1900661,997174,903487,804996,1668,19415,432651,38046,470697,348300,194897,104182,90182,64560,47051,6016,855188,1151349,90.60474902073258,42.35347597493714
Bihar,Samastipur,25.793205563909765,85.94833323308269,221,4261566,2230003,2031563,2142880,5379,50918,1012979,43486,1056465,781038,710468,438908,284082,186153,129933,19126,2549708,1996651,91.10135726274807,50.28386278659066
Bihar,Saran,25.89656077844312,84.82266287425155,219,3951862,2022821,1929041,2157454,4509,37442,701323,76299,777622,793945,693465,433759,361171,213251,148065,9848,2653504,1313700,95.36390021657873,54.59335371528662
Bihar,Sheikhpura,25.12472436548223,85.77839390862944,228,636342,329743,306599,328676,631,8873,108293,24345,132638,129673,110525,59529,52860,33856,19676,3399,409518,305609,92.98120051070076,51.65084184290837
Bihar,Sheohar,26.45838074866311,85.29539411764709,205,656246,346673,309573,283698,478,6698,158484,7516,166000,128209,91277,37063,25657,16031,10091,661,308989,348078,89.29827243540743,43.23043492836528
Bihar,Sitamarhi,26.565700696864127,85.61172491289203,206,3423574,1803252,1620322,1436794,3460,42461,807294,49670,856964,733380,394422,196321,136500,92783,70549,11936,1635891,1852765,89.85554986213796,41.96766303284229
Bihar,Siwan,26.1736372013652,84.33766552901022,218,3330464,1675090,1655374,1930175,3834,37833,632514,41858,674372,689880,612635,445257,355277,186817,119164,12091,2421121,1207119,98.82298861553707,57.95513778260326
Bihar,Supaul,26.281578937728963,86.78496465201462,208,2229076,1155283,1073793,1033283,1845,25078,572287,27815,600102,467768,269737,157787,99530,69665,45726,5850,1116063,1220268,92.94631704958871,46.35476762568885
Bihar,Vaishali,25.8134703180212,85.39247597173153,220,3495021,1844535,1650486,1926740,4810,39564,699317,51494,750811,810191,487594,370247,291392,178320,124448,9094,2271286,1479152,89.47978758874187,55.12813799974307
Chandigarh,Chandigarh,30.7426,76.75872465753423,55,1055450,580663,474787,805438,44283,78113,8911,289456,298367,80406,118667,114209,124707,98786,174528,20188,731491,184265,81.76636017793454,76.31228385996495
Chhattisgarh,Bastar,19.393866751269048,81.52895126903546,414,1413199,698487,714712,650863,1782,9042,316425,54894,371319,183667,178766,139330,60936,57413,32895,3227,656234,729550,102.32287787746945,46.05600485140451
Chhattisgarh,Bilaspur,22.356942982456147,81.99770350877188,30,381956,192764,189192,287620,1574,6281,152458,11987,164445,35817,59489,53515,64730,45695,25474,3241,287961,65864,98.14695690066611,75.3018672307805
Chhattisgarh,Bilaspur,22.356942982456147,81.99770350877188,406,2663629,1351574,1312055,1596560,8566,30892,549632,188174,737806,382091,407692,337793,189296,152838,134637,19654,1624001,943112,97.07607574576012,59.939278330428145
Himachal Pradesh,Bilaspur,31.378042290748898,76.65316079295157,30,381956,192764,189192,287620,1574,6281,152458,11987,164445,35817,59489,53515,64730,45695,25474,3241,287961,65864,98.14695690066611,75.3018672307805
Himachal Pradesh,Bilaspur,31.378042290748898,76.65316079295157,406,2663629,1351574,1312055,1596560,8566,30892,549632,188174,737806,382091,407692,337793,189296,152838,134637,19654,1624001,943112,97.07607574576012,59.939278330428145
Chhattisgarh,Dhamtari,20.554912627291245,81.7569195519348,412,799781,397897,401884,546833,1016,4804,168689,41792,210481,143128,148544,120146,65196,58875,31319,5096,572304,214637,101.00201811021445,68.37284206551544
Chhattisgarh,Durg,21.194463849287164,81.33181639511197,409,3343872,1682101,1661771,2303378,16141,51289,533448,349741,883189,463598,573291,497668,309508,286244,202424,30555,2363288,823501,98.79139243125115,68.88355774383709
Chhattisgarh,Jashpur,22.77286167664669,83.8703962075848,402,851669,424747,426922,495415,567,5755,205670,20722,226392,120768,137681,127299,64188,50562,26161,3166,529825,328438,100.51206953786607,58.16989933882765
Chhattisgarh,Korba,22.491712499999995,82.57604326923074,404,1206640,612915,593725,748759,4544,18004,206598,126055,332653,178191,188303,168387,89167,83166,61215,11792,780221,410186,96.86906014700244,62.05322217065571
Chhattisgarh,Koriya,23.50412776859501,82.12515636363634,400,658917,334737,324180,397823,1667,7609,121852,59763,181615,143413,109639,87969,47127,38677,26802,4134,457761,179639,96.84618073293362,60.375282471085136
Chhattisgarh,Mahasamund,21.22372703777336,82.65925427435384,411,1032754,511967,520787,637963,961,5614,274793,35774,310567,179770,194739,152183,78583,57949,33357,5951,702532,384764,101.72276728773535,61.772987565286606
Chhattisgarh,Raigarh,22.008265068493166,83.27797698630134,403,1493984,750278,743706,951639,3342,13857,354278,66638,420916,246480,260661,210964,130700,93340,66358,8804,1017307,460166,99.1240580158288,63.6980717330306
Chhattisgarh,Raigarh,22.008265068493166,83.27797698630134,520,2634200,1344345,1289855,1939994,38570,96301,581868,377160,959028,231263,407662,335886,441072,221410,204507,19940,1861740,482420,95.94672498502989,73.64642016551515
Chhattisgarh,Raipur,20.88603153846152,82.20032759615388,410,4063872,2048186,2015686,2629749,20261,59523,673499,395001,1068500,618508,664470,552373,313247,267265,227382,31483,2674728,1247434,98.41323004844287,64.71042887177549
Chhattisgarh,Surguja,23.327192787286076,83.23582493887531,401,2359886,1193129,1166757,1187941,2737,18983,525596,65167,590763,364452,338509,281260,135374,105992,64607,9524,1299718,991866,97.78967739448123,50.33891467638691
Goa,North Goa,15.548723418714054,73.80667997909038,585,818008,416677,401331,663060,23440,56266,115859,209230,325089,40968,101521,148792,153887,87513,86781,16601,636063,99538,96.31705133712684,81.05788696443066
Goa,South Goa,15.195278658183785,73.94179259687701,586,640537,322463,318074,502427,17624,44299,88620,162873,251493,29874,73039,119869,108989,64786,57460,9579,463596,88577,98.63891361179422,78.43840402662141
Gujarat,Amreli,21.04832649310872,71.43457637825426,480,1514190,771049,743141,995459,2538,12765,313714,116899,430613,230474,412251,120625,149478,66785,50999,8582,1039194,380595,96.38051537580621,65.74201388200952
Gujarat,Anand,22.282718206229863,72.57782051557454,482,2092745,1087224,1005521,1551253,9902,32523,413078,208909,621987,257524,560542,229013,283571,127459,110351,20487,1588947,360506,92.485173248567,74.12527565470232
Gujarat,Banas Kantha,24.25853896551725,71.93205252873561,469,3120506,1610379,1510127,1704923,3424,23149,666773,137424,804197,366867,859436,159433,226765,105372,66950,14451,1799274,1207376,93.77463317641374,54.63610709288814
Gujarat,Bharuch,21.75787276237761,72.67326346710801,488,1551019,805707,745312,1118276,10257,29531,300677,181319,481996,161675,367060,164765,188539,83895,74380,16036,1056350,273829,92.5040988845821,72.09943914291186
Gujarat,Bhavnagar,21.70219390341736,72.16272632761141,481,2880365,1490201,1390164,1887255,7297,28925,387251,356826,744077,422461,929286,266953,281250,96241,93391,13946,2103528,508664,93.28701295999667,65.52138357465113
Gujarat,Gandhinagar,23.19367979002625,72.67221679790026,473,1391753,723864,667889,1030494,12107,33662,237624,195634,433258,136131,363156,133594,196456,95730,108400,16088,1049555,246993,92.26719383751643,74.04287973512541
Gujarat,Jamnagar,22.410600414263328,69.62062005768232,477,2160119,1114192,1045927,1396534,11573,30384,347158,299167,646325,255785,491009,194057,199634,74029,87523,18573,1320610,502873,93.87313856139696,64.65079007221361
Gujarat,Junagadh,20.929523011609785,70.54733890140345,479,2743082,1404356,1338726,1842818,6628,26991,489237,287506,776743,271762,700258,294811,311849,137505,139957,30127,1886269,669022,95.32668354747656,67.18056550988997
Gujarat,Kachchh,23.48057203301311,68.82192301497915,468,2092371,1096737,995634,1252319,9631,31961,488293,250982,739275,246956,469402,141345,157284,61366,60386,14062,1150801,581952,90.78147267758816,59.851670664523645
Gujarat,Kheda,22.887653125000018,73.018803515625,483,2299885,1185727,1114158,1660243,5710,24502,461479,160547,622026,295057,641541,250044,310341,148530,84223,19498,1749234,482078,93.96412496299739,72.18808766525284
Gujarat,Narmada,21.70666386292833,73.68403208722742,487,590297,301086,289211,370336,576,4081,138121,22248,160369,76197,146661,58188,52687,28396,14748,3451,380328,192780,96.05594414884784,62.73723227460075
Gujarat,Navsari,20.866973318871995,72.86184869848157,490,1329672,678165,651507,1001909,6726,24397,267739,141417,409156,145678,266733,140235,190861,112460,85041,26012,967020,261956,96.06909822830727,75.35008633708162
Gujarat,Patan,23.80634198473284,71.75162977099238,470,1343734,694397,649337,837913,2231,12870,301483,102655,404138,168990,364667,78731,129584,57494,46355,11111,856932,452891,93.5109166658266,62.3570587631183
Gujarat,Porbandar,21.550923516515716,69.71896987722886,478,585449,300209,285240,393678,1653,5639,96015,87557,183572,50588,150643,71637,63458,25119,22458,5260,389163,137119,95.01380704775673,67.24377358232742
Gujarat,Rajkot,22.40603377715488,70.83679439383323,476,3804558,1974445,1830113,2725056,21785,67370,459474,721532,1181006,383780,913928,402240,540278,204306,266295,29924,2740751,738660,92.68999642937635,71.62608639426709
Gujarat,Sabar Kantha,23.71803594548552,73.13638790459964,472,2428589,1244231,1184358,1578734,5262,25425,544024,121509,665533,214062,597667,211423,333650,198963,110817,24745,1691327,665058,95.18795143345568,65.00622377849854
Gujarat,Surat,21.25761372772093,72.93488716344339,492,6081322,3402224,2679098,4571410,55694,149331,369840,1529998,1899838,566242,1332690,807021,896927,433651,379505,79862,4495898,942150,78.74549118458984,75.17131965714033
Gujarat,Surendranagar,22.82672007299272,71.48358740875906,475,1756268,909917,846351,1093626,2975,15309,340788,159810,500598,234873,482679,165406,172947,61164,58389,14501,1189959,493427,93.01408809814522,62.269881362070024
Gujarat,The Dangs,20.801633877551023,73.68835183673471,489,228291,113821,114470,140968,137,1393,52102,7516,59618,43639,59954,17736,14872,7560,3490,2215,149466,91160,100.57019354952075,61.749258621671466
Gujarat,Vadodara,22.26133739279589,73.49433010291594,486,4165626,2153736,2011890,2893080,53606,117818,547454,692971,1240425,396624,865726,457662,504732,268451,314960,60177,2868332,910219,93.41395602803686,69.45126614823319
Gujarat,Valsad,20.44238231644259,72.91485847983449,491,1705678,887222,818456,1170657,11020,31285,262410,235981,498391,165459,303197,171712,212318,123281,90912,26987,1093866,405928,92.24929048197633,68.63294244282918
Haryana,Ambala,30.3503672316384,76.94970310734456,70,1128350,598703,529647,818025,12899,32767,175365,139891,315256,89558,170110,161844,163544,97980,91472,18727,793235,222031,88.46573342709156,72.49745203172775
Haryana,Bhiwani,28.728868064516128,76.02110225806452,81,1634445,866672,767773,1069871,5292,25236,357047,99235,456282,186145,223049,198307,218631,148995,104875,13786,1093788,459364,88.5886471467868,65.45775477302693
Haryana,Faridabad,28.148731097560983,77.3271853658537,88,1809733,966110,843623,1272739,43437,82673,87700,382981,470681,137902,220384,198551,282666,178846,259933,27864,1306146,346567,87.32163004212771,70.32744609287668
Haryana,Fatehabad,29.57298318584072,75.54608716814157,78,942011,495360,446651,557578,3210,13142,203020,55360,258380,103541,136663,99948,93526,61476,37741,9504,542399,344534,90.16694928940568,59.19017930788494
Haryana,Gurgaon,28.043894789579163,77.01935130260524,86,1514432,816690,697742,1111116,67087,102343,141703,381988,523691,126920,177453,175370,219200,150120,233402,41366,1123831,263720,85.43535490822711,73.3684972319655
Haryana,Hisar,29.23628731117825,75.84324682779452,80,1743931,931562,812369,1114311,10132,33400,302013,154113,456126,197303,230074,194595,202792,144626,105346,19031,1093767,505251,87.205038419343,63.89650737328484
Haryana,Jhajjar,28.59651868131869,76.61137142857146,83,958405,514667,443738,676091,5034,19241,211816,78328,290144,90737,109829,115794,145258,97457,58826,9387,627288,201028,86.21846747508583,70.5433506711672
Haryana,Jind,29.45149821958457,76.29598575667653,77,1334152,713006,621146,832758,5263,23750,278335,89665,368000,136892,185626,151682,154773,107994,64599,14277,815843,419624,87.1165179535656,62.41852502563427
Haryana,Kaithal,29.960685390946487,76.37698930041155,73,1074304,571003,503301,646529,3724,15301,231091,75696,306787,119345,158239,124682,117753,82297,51043,9111,662470,369869,88.14331973737441,60.18119638389133
Haryana,Karnal,29.703200647249204,76.87488025889972,74,1505324,797712,707612,978013,11163,29253,292682,135920,428602,155839,231354,188040,183590,124790,101387,19186,1004186,429220,88.70519686302826,64.97026553751883
Haryana,Kurukshetra,30.05652659846548,76.78774680306903,72,964655,510976,453679,646893,7356,21951,203553,88268,291821,94530,145392,118107,120790,81964,71007,10999,642789,266638,88.78675319388778,67.05951868802836
Haryana,Mahendragarh,28.1352161458333,76.14018072916659,84,922088,486665,435423,630255,2624,13908,223726,44216,267942,94273,135849,126291,132765,94245,60296,10353,654072,245602,89.47078585885568,68.35085154562255
Haryana,Panchkula,30.700897142857126,76.97173238095236,69,561293,299679,261614,405318,18615,32174,70895,93656,164551,45607,73584,60177,69163,48306,83256,8466,388559,119222,87.29807560756676,72.2114831291322
Haryana,Panipat,29.343521341463426,76.92895914634147,75,1205437,646857,558580,786599,10024,26719,173502,153804,327306,118873,170565,143466,141473,91756,75774,10977,752884,296212,86.35293426522401,65.25426048810515
Haryana,Rewari,28.19164714828897,76.55956007604564,85,900332,474335,425997,636947,5121,18092,199449,69305,268754,81280,120860,122617,139646,95807,65143,9820,635173,206827,89.80931198414622,70.74579155244955
Haryana,Rohtak,28.892517647058817,76.53123235294117,82,1061204,568479,492725,747582,8482,27225,175203,131739,306942,117097,150903,140782,168499,109596,100346,21134,808357,248795,86.67426589196786,70.44658708410448
Haryana,Sirsa,29.63583446327684,74.90970480225988,79,1295189,682582,612607,782897,6287,22706,245476,93316,338792,141766,201349,153263,134559,83373,61620,16698,792628,412353,89.74848443117457,60.446544867196984
Himachal Pradesh,Chamba,32.66741814595661,76.39354063116366,23,519080,261320,257760,323842,1615,5117,186395,13836,200231,56272,96789,67653,64515,40440,15506,3252,344427,154575,98.63768559620388,62.3876859058334
Himachal Pradesh,Hamirpur,31.67668481012659,76.49767088607594,28,454768,217070,237698,358091,2521,7525,196116,15232,211348,37327,71107,72114,91184,64363,35620,5263,376978,72551,109.50292532362833,78.74146817718045
Himachal Pradesh,Hamirpur,31.67668481012659,76.49767088607594,168,1104285,593537,510748,653299,1196,11037,256081,55300,311381,159593,238344,211029,103334,59914,59612,4094,835920,364848,86.05158566357278,59.16036168199332
Uttar Pradesh,Hamirpur,25.73815838150289,79.82619479768789,28,454768,217070,237698,358091,2521,7525,196116,15232,211348,37327,71107,72114,91184,64363,35620,5263,376978,72551,109.50292532362833,78.74146817718045
Uttar Pradesh,Hamirpur,25.73815838150289,79.82619479768789,168,1104285,593537,510748,653299,1196,11037,256081,55300,311381,159593,238344,211029,103334,59914,59612,4094,835920,364848,86.05158566357278,59.16036168199332
Himachal Pradesh,Kangra,32.14093603238864,76.41205910931173,24,1510075,750591,759484,1152640,8053,22753,588321,39007,627328,127699,243617,223099,284124,192936,91236,13577,1176288,271892,101.18479971116095,76.32998361008559
Himachal Pradesh,Kinnaur,31.606671840659327,78.51613736263741,34,84121,46249,37872,60699,354,2563,44514,0,44514,9400,13749,11437,11140,7871,5118,713,59428,16944,81.88717593893922,72.15677417054005
Himachal Pradesh,Kullu,31.909119220779253,77.40922649350647,26,437903,225452,212451,307672,2623,7010,167995,20709,188704,48384,77363,61854,58122,39081,23168,2377,310349,103136,94.23336231215514,70.26030878984615
Himachal Pradesh,Mandi,31.63580594059405,76.96556930693067,27,999777,498065,501712,723747,5333,16401,431129,31696,462825,100052,159043,132147,180188,128549,54139,9350,763468,218570,100.73223374459157,72.39084315802424
Himachal Pradesh,Shimla,31.15572545180725,77.62573042168668,33,814010,425039,388971,612642,9177,24127,279269,95896,375165,69967,113536,113305,141490,95341,80414,9748,623801,137576,91.51419046252227,75.26222036584316
Himachal Pradesh,Sirmaur,30.682764453961443,77.43184689507494,32,529855,276289,253566,362645,2220,8593,171102,21054,192156,57853,100123,78103,67080,38282,23352,4048,368841,140486,91.77564072402447,68.44230968849968
Himachal Pradesh,Solan,31.03864311926604,76.94442140672783,31,580320,308754,271566,428578,5250,14478,192787,51509,244296,50331,89407,83992,95232,59363,36803,8280,423408,104084,87.95545968635224,73.85201268265784
Himachal Pradesh,Una,31.58330388349513,76.18353932038835,29,521173,263692,257481,399715,2412,8238,185091,20126,205217,51838,87913,81256,105204,60626,32120,5511,424468,87735,97.64460051878707,76.69526241766171
Jharkhand,Bokaro,23.6814965034965,85.98398374125864,355,2062330,1072807,989523,1273520,9754,37997,250312,258452,508764,242467,338861,342646,232434,154076,116396,21157,1448037,595924,92.23681426388903,61.75151406418953
Jharkhand,Chatra,24.11619945750453,84.93295804701627,347,1042886,533935,508951,510061,590,9115,200974,14528,215502,200861,161729,102033,63670,35342,21697,2046,587378,467975,95.32077874647663,48.908605542695945
Jharkhand,Deoghar,24.33070100755672,86.75697632241814,350,1492073,775022,717051,793538,1944,13550,257373,64337,321710,217460,266292,190171,96331,54419,43979,6699,875351,635544,92.52008330086113,53.18359088328788
Jharkhand,Dhanbad,23.854509090909094,86.40372924901185,354,2684487,1405956,1278531,1722204,11568,46646,258764,405455,664219,317918,501453,449506,305054,186697,107382,14615,1882625,662522,90.93677184776764,64.15393332133849
Jharkhand,Dumka,24.275006125574265,87.27662450229711,362,1321442,668514,652928,672409,1193,10396,303697,23281,326978,229157,229259,149009,69525,38383,25593,2697,743623,601078,97.66856041907873,50.88448830898366
Jharkhand,Garhwa,24.08211468926553,83.68664265536722,346,1322784,683575,639209,653476,565,8881,272872,19180,292052,207665,195565,147446,87844,46882,28144,2830,716376,557852,93.5097099806166,49.4015651837337
Jharkhand,Giridih,24.30578509874329,86.08710915619386,349,2445474,1258098,1187376,1253475,1944,19976,452564,46886,499450,503261,443980,261309,146464,77540,55122,8449,1496125,1047685,94.37865730650553,51.256934238515726
Jharkhand,Godda,24.8189,87.29417354838709,351,1313551,677927,635624,604519,874,11925,276454,15576,292030,217607,190777,126766,79430,47395,30870,4002,696847,653464,93.75994760497812,46.02173802159185
Jharkhand,Gumla,23.078532948929148,84.55056787479396,366,1025213,514390,510823,559720,831,7807,216629,16445,233074,136719,242580,182260,82114,45613,23742,2913,715941,322119,99.30655728144015,54.5954840603855
Jharkhand,Jamtara,23.97873318077801,86.95325080091534,363,791042,404830,386212,426312,808,4959,165555,20113,185668,131150,132014,85745,40613,22995,14802,1578,428897,366012,95.401032532174,53.89246083014555
Jharkhand,Latehar,23.72511185840708,84.48298743362838,359,726978,369666,357312,350682,340,6240,146377,14137,160514,109491,121529,88787,46142,23885,13956,1017,404807,349277,96.65806430669848,48.23832358063105
Jharkhand,Lohardaga,23.488796043165483,84.6605169064748,356,461790,232629,229161,259707,351,2954,96759,14725,111484,82873,84920,63545,38503,21987,13847,976,306651,188323,98.50921424242034,56.239199636198265
Jharkhand,Pakur,24.57260428082189,87.69691969178076,353,900422,452661,447761,352881,328,4535,200588,16587,217175,100367,133770,79045,29934,15700,9822,1525,370163,548434,98.91751222217067,39.19062395188034
Jharkhand,Palamu,24.196925968109337,84.20310842824594,358,1939869,1006302,933567,1024563,2155,19981,355529,52375,407904,303053,296937,231565,160964,100290,63595,7117,1163521,803424,92.7720505375126,52.81609222066026
Jharkhand,Ranchi,23.18423506139155,85.31781937244203,364,2914253,1494937,1419316,1911433,22538,76565,420740,310242,730982,361522,547583,495515,370847,247237,195181,28424,2246309,613855,94.94152596397039,65.58912352496506
Jharkhand,Sahibganj,24.93667989690721,87.68264097938143,352,1150567,589391,561176,483263,591,9563,223450,37543,260993,146399,171416,110822,52248,28087,19832,2593,531397,637296,95.21285530318583,42.00216067382429
Jharkhand,Simdega,22.60876039119805,84.59193691931536,367,599578,300309,299269,343483,423,4649,144169,11114,155283,82317,130068,97580,47836,24842,13674,1197,397514,191341,99.65369003259975,57.28745884605506
Karnataka,Bagalkot,16.15860676328503,75.64526070853469,556,1889752,950111,939641,1113412,3745,26297,324799,165858,490657,242336,385986,147397,171505,115095,82319,25791,1170429,608843,98.898023494097,58.9184189248113
Karnataka,Bangalore Rural,12.936827087794446,77.47369314775169,583,990923,509172,481751,688749,3729,17066,231052,95410,326462,100770,168165,126285,166677,82235,51015,10741,705888,205062,94.61458996174181,69.50580418458347
Karnataka,Belgaum,16.16107219152853,74.72329042357275,555,4779661,2423063,2356598,3052032,17560,73497,962777,356198,1318975,544564,1057297,609600,532584,279583,201884,56621,3282133,1346776,97.25698423854435,63.85457043920061
Karnataka,Bellary,15.074377548209371,76.47228471074374,565,2452595,1236954,1215641,1421621,9626,40190,371604,251876,623480,275785,529576,219702,203139,121453,89475,29367,1468497,787762,98.2769771551731,57.96395246667305
Karnataka,Bidar,17.950361730769227,77.1945996153846,558,1703300,870665,832635,1042673,3971,36072,287134,102269,389403,188998,474921,194233,181076,105347,54900,12885,1212360,515395,95.6320743339861,61.21487700346386
Karnataka,Bijapur,16.84015316666667,75.95909166666667,417,255230,128663,126567,86919,117,1462,50449,7942,58391,25597,22787,14170,7192,6755,3421,147,80069,163278,98.37093803191283,34.05516592877013
Karnataka,Bijapur,16.84015316666667,75.95909166666667,557,2177331,1111022,1066309,1248268,4987,36571,396449,131041,527490,246391,430477,143199,182756,129109,96990,24569,1253491,746979,95.9755072356803,57.330190035414915
Karnataka,Chitradurga,14.29102220394736,76.57821957236844,566,1659456,840843,818613,1087392,5711,28897,349704,97644,447348,188329,332648,196470,217567,132435,75262,22078,1164789,452975,97.35622464598028,65.52701608237881
Karnataka,Davanagere,14.330414586709884,75.91723841166937,567,1945497,986400,959097,1308540,7320,39416,354680,176011,530691,242130,446793,206686,269748,154781,123863,32375,1476376,467414,97.23205596107056,67.25993409396159
Karnataka,Dharwad,15.34383137697517,75.13831264108359,562,1847023,937206,909817,1301664,15013,49585,199707,283397,483104,252596,383041,185530,227113,143453,137768,34302,1363803,428556,97.07759019895306,70.47362160622797
Karnataka,Gadag,15.507128256880744,75.64861302752298,561,1064570,537147,527423,700177,3373,15625,180066,111906,291972,121615,244640,112703,105150,63816,42053,12822,702799,306138,98.18969481352404,65.77087462543562
Karnataka,Gulbarga,17.070459515951594,76.87503850385032,579,2566326,1301755,1264571,1427368,9752,52483,400704,199303,600007,177860,579057,270622,290570,153746,104256,20492,1596603,883704,97.1435485171941,55.61912243417243
Karnataka,Hassan,12.945098749999998,76.11049549999997,574,1776421,883667,892754,1225256,4851,23444,496103,132878,628981,182255,354480,232531,292369,147837,103152,27774,1340398,401227,101.02832854457617,68.9732895524203
Karnataka,Haveri,14.73758280922432,75.3961230607966,564,1597668,819128,778540,1085443,2456,17819,315076,98488,413564,240925,430529,201965,158442,84357,55310,16830,1188358,383494,95.04497465597562,67.93920889696733
Karnataka,Kodagu,12.39684468085106,75.79336595744687,576,554519,274608,279911,412877,3308,10758,181182,31792,212974,51287,111562,75291,86232,54939,43225,8251,430787,91352,101.93111635494961,74.4567814628534
Karnataka,Kolar,13.312799881235172,78.01376947743476,581,1536401,776396,760005,1016219,5051,27235,326567,151042,477609,138015,289841,228422,225498,107929,71422,17961,1079088,399089,97.88883507900607,66.14282339050807
Karnataka,Koppal,15.651253271028034,76.16170485981309,560,1389920,699926,689994,809085,2135,15263,272968,64681,337649,222140,357098,127605,113028,72243,43967,10431,946512,472182,98.58099284781534,58.210904224703576
Karnataka,Mandya,12.574901806239744,76.81570098522172,573,1805769,905085,900684,1149649,3367,20265,458867,103435,562302,145178,309476,226552,308624,157839,102838,19987,1270494,504734,99.51374732759906,63.66534146947921
Karnataka,Mysore,12.248100259403367,76.52881802853437,577,3001127,1511600,1489527,1962180,28397,80086,540596,380386,920982,207091,537686,404565,452412,222230,212541,26834,2063359,747237,98.53975919555438,65.38143837298455
Karnataka,Raichur,16.050795353982295,76.87368606194688,559,1928812,964511,964301,979769,5200,33903,330446,125402,455848,147743,385673,163709,153346,82082,50463,14622,997638,783126,99.97822730896796,50.79650064391967
Karnataka,Shimoga,14.063845885634592,75.17882078103197,568,1752753,877415,875338,1263016,8791,35207,352444,201662,554106,191641,385978,292481,251095,132138,111753,18036,1383122,355222,99.76328191334774,72.058983781514
Karnataka,Tumkur,13.592467760074973,77.02297966260545,571,2678980,1350594,1328386,1813391,7971,41751,685443,204799,890242,270373,500593,386998,423738,213588,143735,30687,1969712,686274,98.35568646092015,67.68960574547029
Karnataka,Udupi,13.450404228534568,74.72009990316337,569,1177361,562131,615230,926429,9070,24817,269817,115572,385389,142493,286193,176260,178094,109663,107279,18444,1018426,204028,109.44601881056195,78.68691081155228
Kerala,Alappuzha,9.542602965599087,76.38010796263319,598,2127789,1013142,1114647,1852797,28842,71593,331419,392117,723536,133039,334339,418953,573306,274789,198858,58096,1991380,163991,110.01883250324238,87.07616215705599
Kerala,Ernakulam,10.004879301987431,76.26957729035381,595,3282388,1619557,1662831,2855676,88737,184167,369694,804997,1174691,212263,446380,554817,702511,389793,429880,113133,2848777,268315,102.67196523493772,86.99995247362591
Kerala,Idukki,9.80480963855423,77.04586641566264,596,1108974,552808,556166,923010,8250,24863,391610,20823,412433,79149,166604,209398,261237,136428,86136,19252,958204,126589,100.6074441759164,83.23098647939446
Kerala,Kannur,11.941523076923056,75.35209891725934,589,2523003,1181446,1341557,2138434,32653,83940,306288,566191,872479,204713,487016,491844,540383,308670,217203,40277,2290106,279352,113.55212172202538,84.75748938863728
Kerala,Kasaragod,12.33310309912974,75.07768497134369,588,1307375,628613,678762,1037492,10378,32484,251641,166164,417805,115476,268084,230416,238900,122657,76192,16585,1068310,212905,107.97772238245153,79.35687924275744
Kerala,Kollam,8.929388820570157,76.63607758524309,600,2635375,1246968,1388407,2240273,31542,83133,523715,401415,925130,172247,406592,562529,595191,307950,233402,64052,2341963,231286,111.34263268985252,85.00775032016317
Kerala,Kottayam,9.643701174068417,76.46059673302705,597,1974551,968289,1006262,1749798,37849,83999,481967,196194,678161,117681,271496,373998,475724,280720,221350,52339,1793308,134393,103.92165975240863,88.61751355118201
Kerala,Kozhikode,11.392924270557025,75.71158720159153,591,3086293,1470942,1615351,2615443,36791,107602,323793,666543,990336,247996,564392,647221,630818,351267,250117,53166,2744977,335520,109.81745031415242,84.74383345975252
Kerala,Malappuram,10.97329875666072,75.93910775606876,592,4112920,1960328,2152592,3311315,27909,119918,634543,522586,1157129,415601,770417,814285,933793,392867,203779,41344,3572086,622345,109.80774645875589,80.51007556675063
Kerala,Palakkad,10.784926903553291,76.49980490693744,593,2809934,1359478,1450456,2239492,27162,69440,665899,228442,894341,249198,492864,608176,572412,232109,180540,36370,2371669,439934,106.69212741949482,79.69909613535407
Kerala,Thiruvananthapuram,8.537101759082223,76.88711502868074,601,3301427,1581678,1719749,2785408,71621,155321,559293,609824,1169117,206328,460690,642470,682156,389161,381782,76129,2838716,309042,108.72940004223364,84.36981947503307
Kerala,Thrissur,10.458932647907687,76.12321940836945,594,3121200,1480763,1640437,2678548,56148,132774,336748,715119,1051867,222627,445696,524387,821831,362657,338600,71535,2787333,307665,110.78322459434764,85.81789055491478
Kerala,Wayanad,11.715277464788734,76.07587007042254,590,817420,401684,415736,645585,4712,15944,266183,11805,277988,65326,144896,137227,184266,87042,51111,8786,678654,131211,103.49827227372761,78.97837097208289
Madhya Pradesh,Anuppur,23.18184220430107,81.86560000000007,461,749237,379114,370123,436595,1290,7266,147388,60325,207713,113208,115716,93450,58536,42743,31646,3066,458365,271733,97.62841783737873,58.27194866243926
Madhya Pradesh,Ashoknagar,24.630988461538447,77.82974493927135,459,845071,443837,401234,469109,619,6016,169606,37135,206741,148647,117053,62802,51499,29551,22791,3466,435809,359525,90.40120584809289,55.51119373401762
Madhya Pradesh,Balaghat,21.80020720640569,80.42170053380795,457,1701698,842178,859520,1147623,1712,13306,400074,70793,470867,290699,312640,235251,168635,126308,74213,7414,1215160,493415,102.05918463792689,67.43987476038639
Madhya Pradesh,Barwani,21.702135714285728,74.91004719710673,441,1385881,699340,686541,549926,1158,8516,250358,48912,299270,157337,137116,74067,59100,42649,30754,2581,503604,825034,98.16984585466297,39.68060749804636
Madhya Pradesh,Betul,21.964626315789477,77.78734281891171,447,1575362,799236,776126,939769,2109,13755,318945,87704,406649,239114,232532,176325,140402,105696,82761,5876,982706,603098,97.10848860661933,59.654162027521295
Madhya Pradesh,Bhind,26.35951126187245,78.7618324287653,420,1703005,926843,776162,1094917,1166,14368,271211,88385,359596,202629,261162,199044,140743,96011,50222,8059,957870,388473,83.74255402479169,64.29323460588783
Madhya Pradesh,Bhopal,23.48072614379085,77.39246623093679,444,2371061,1236130,1134931,1660690,40788,94729,118893,581826,700719,229082,303171,287198,211371,178165,266618,30845,1506450,462581,91.81323970779772,70.03995257819179
Madhya Pradesh,Burhanpur,21.364567254408065,76.24460478589425,467,757847,388504,369343,408679,986,5058,115979,62861,178840,107547,119468,69765,57058,42618,28237,4761,429454,317962,95.06800444783066,53.92632022030832
Madhya Pradesh,Chhatarpur,24.813637376460004,79.56449299191374,425,1762375,936121,826254,943033,1880,15567,375869,95048,470917,270951,236054,160310,112961,77787,59704,7837,925604,770268,88.2635898564395,53.50921341939144
Madhya Pradesh,Chhindwara,22.227966971713823,78.76413136439255,455,2090922,1064468,1026454,1294198,3588,20034,413142,140802,553944,284113,336391,225747,215098,167946,112383,12141,1353819,663446,96.42882641845503,61.89604394616346
Madhya Pradesh,Damoh,23.76624407960196,79.47049303482588,428,1264219,661873,602346,747715,1432,10504,303387,66514,369901,197917,217296,150040,95032,64414,41158,5260,771117,469038,91.0062806610936,59.1444203891889
Madhya Pradesh,Datia,25.90226439560441,78.63916571428574,422,786754,420157,366597,491445,616,5251,160453,43401,203854,132176,131372,88949,73398,48978,34853,4262,513988,260076,87.25238422780056,62.46488737267304
Madhya Pradesh,Dewas,22.7851110021322,76.46088805970156,437,1563715,805359,758356,925369,3518,16523,274995,101014,376009,242508,225380,149522,125772,94403,55383,4991,897959,565365,94.16372077545542,59.17759949862986
Madhya Pradesh,Dhar,22.57268171896316,75.1105620736698,438,2185793,1112725,1073068,1077338,2388,18626,412348,103364,515712,262090,244058,164576,134279,99882,66721,6543,978149,1021851,96.43604664225212,49.28819883676084
Madhya Pradesh,Dindori,22.83738437047757,81.04332966714911,453,704524,351913,352611,378714,554,6447,218021,9774,227795,103002,113875,84065,49277,31104,15179,1674,398176,295655,100.19834447718611,53.754591752729496
Madhya Pradesh,Guna,24.49043927178156,77.2235895968791,458,1241519,649362,592157,653980,2482,11740,212765,72320,285085,197902,157141,84560,79924,50724,42147,6451,618849,578034,91.19058398859188,52.67579473209834
Madhya Pradesh,Gwalior,26.04074441964285,78.12782433035713,421,2032036,1090327,941709,1357210,15779,46454,172720,272172,444892,235648,235924,204871,193082,166719,193947,23148,1253339,554486,86.36941027783408,66.79064740978998
Madhya Pradesh,Harda,22.227659781121783,77.07022571819434,448,570465,294838,275627,352550,986,5376,112714,31845,144559,90059,87733,60757,46556,31939,27126,3469,347639,177731,93.48421845216696,61.80046102740746
Madhya Pradesh,Hoshangabad,22.595268801996703,78.02168094841929,449,1241350,648725,592625,810644,2871,14456,209650,105746,315396,159703,183156,145076,119682,89589,84769,9279,791254,344492,91.35226791013142,65.3034196640754
Madhya Pradesh,Indore,22.680265752128648,75.9133801324502,439,3276697,1699627,1577070,2309130,48691,111478,200371,587947,788318,428413,472233,384611,362209,300076,382658,36326,2366526,718174,92.78918256770456,70.47127030665331
Madhya Pradesh,Jabalpur,23.18525572327043,79.98328754716981,451,2463289,1277278,1186011,1756468,20443,58601,272284,352477,624761,267932,352284,313910,268333,222987,235072,24872,1685390,540029,92.85457042241391,71.30580293258323
Madhya Pradesh,Jhabua,22.419578015397764,74.4092161676647,464,1025048,515023,510025,352081,744,5591,211080,24713,235793,98308,79781,40466,38236,28990,20240,1973,307994,775664,99.02955790323928,34.34775737331325
Madhya Pradesh,Katni,23.724416229116937,80.33819665871127,450,1292042,662013,630029,790773,2179,13094,276151,72880,349031,198447,207366,161727,112242,80935,53578,6658,820953,465374,95.16867493538646,61.20335097465872
Madhya Pradesh,Mandla,22.70348712446353,80.38600543633753,454,1054905,525272,529633,604962,912,9042,279674,37258,316932,156711,170994,115632,82166,58066,35476,4587,623632,376944,100.83023652507651,57.347533664168814
Madhya Pradesh,Mandsaur,24.19278764044944,75.43588667736759,433,1340411,682851,657560,834591,2324,12507,302287,81832,384119,244891,217234,149219,109751,77219,52546,4956,855816,467002,96.29626375300029,62.26381311403741
Madhya Pradesh,Morena,26.37313504531724,77.88447341389724,419,1965970,1068417,897553,1179685,1781,20172,319298,95288,414586,288979,285682,228234,170254,115790,71005,8265,1168209,706917,84.00774229537717,60.00523914403577
Madhya Pradesh,Neemuch,24.70311893333336,75.06608186666664,432,826067,422653,403414,508834,1945,8342,174235,67962,242197,137656,127167,83189,69134,53465,42343,6119,519073,289113,95.44803893501287,61.59718279510016
Madhya Pradesh,Panna,24.45132584009265,80.21133001158752,426,1016520,533480,483040,552559,653,8501,256744,32179,288923,171707,134936,99251,70359,47903,29795,3052,557003,427997,90.5451000974732,54.35790737024357
Madhya Pradesh,Raisen,23.292518206521727,78.16305495923909,446,1331597,700358,631239,820220,1141,9931,251272,74441,325713,237981,210402,144108,117908,69419,48384,4607,832809,444877,90.13090448028008,61.59671432122481
Madhya Pradesh,Rajgarh,23.785499026425587,76.66431223922115,442,1545814,790212,755602,804245,1611,12718,331894,69823,401717,239738,174381,103464,96386,72316,51499,4799,742583,706958,95.6201626905185,52.0272814193687
Madhya Pradesh,Ratlam,23.503562290502792,75.14895782122909,434,1455069,738241,716828,825880,3644,14905,266716,107151,373867,224715,194131,129392,111461,86507,67192,5868,819266,622153,97.0994566814902,56.75882037209232
Madhya Pradesh,Rewa,24.86118462515885,81.57572465057183,430,2365106,1225100,1140006,1441757,3406,31194,523910,94489,618399,344362,330131,312931,206274,180635,122371,11438,1508142,766166,93.05411803118113,60.959508791572134
Madhya Pradesh,Sagar,23.800318709677374,78.71940357771274,427,2378458,1256257,1122201,1545719,4546,24811,448408,165507,613915,347752,426916,297079,214137,137899,116753,14346,1554882,711804,89.32893508255079,64.98828232409402
Madhya Pradesh,Satna,24.62777621776502,80.75547048710598,429,2228935,1157495,1071440,1371781,3754,22751,461831,114173,576004,338947,334635,309536,197373,148091,105499,16052,1450133,715509,92.56541064972203,61.54423525136444
Madhya Pradesh,Sehore,22.9297199679658,77.06780202883084,445,1311332,683743,627589,780362,1566,11166,270427,59220,329647,193885,179388,136284,120687,77541,50655,6755,765195,508396,91.7872650981436,59.509109821158944
Madhya Pradesh,Seoni,22.33230487804874,79.66053863928111,456,1379131,695879,683252,864194,1182,10417,335045,47542,382587,223650,241327,151636,116124,84398,55984,6427,879546,458811,98.18546040331725,62.66221265420037
Madhya Pradesh,Shahdol,23.448598645598192,81.4596831828442,460,1066063,540021,526042,604194,1733,10817,233594,57846,291440,161972,154282,128427,80402,60915,46513,5352,637863,422736,97.41139696419214,56.67526215617651
Madhya Pradesh,Shajapur,23.56662031722055,76.33555181268885,436,1512681,780520,732161,894612,1382,10797,312611,73997,386608,271215,239081,141225,111366,75967,48671,3391,890916,544791,93.80425869932866,59.14082347831433
Madhya Pradesh,Sheopur,25.78014810996563,77.16911116838484,418,687861,361784,326077,328025,273,5393,150146,26376,176522,90911,70840,43009,37072,24732,17091,1497,285152,393141,90.13029874179068,47.687686901859536
Madhya Pradesh,Shivpuri,25.378024518743672,77.74861600810549,423,1726050,919795,806255,900846,1852,15304,367859,66759,434618,261087,214162,125117,84684,58509,44812,6218,794589,719547,87.65594507471774,52.19118797253846
Madhya Pradesh,Sidhi,24.17547189952905,82.1053783359498,462,1127033,575912,551121,600785,837,10790,250953,25916,276869,185550,168224,129344,80312,60845,33067,3896,661238,477472,95.69534928947479,53.306779836970165
Madhya Pradesh,Tikamgarh,25.14099852104666,78.89357064846428,424,1445166,760355,684811,747940,1090,10899,322772,60220,382992,202448,188694,143231,78053,58245,35034,5340,711045,659348,90.06464085854634,51.75460812114318
Madhya Pradesh,Ujjain,23.319288862745065,75.80383717647058,435,1986864,1016289,970575,1240990,7501,27733,300765,188684,489449,286534,280030,178295,159263,119586,111290,13282,1148280,659279,95.50187003893578,62.45973554304673
Madhya Pradesh,Umaria,23.59601063063061,80.90879477477475,431,644758,330674,314084,356672,839,6360,138100,29966,168066,90791,94011,74854,43418,27216,18144,2784,351218,230782,94.98297416791159,55.318739744214106
Madhya Pradesh,Vidisha,23.82838307984792,77.9013507604563,443,1458875,769568,689307,862918,1926,12888,292579,83830,376409,242021,214603,123650,104007,65581,59814,6780,816456,512311,89.57064223044617,59.1495501670808
Maharashtra,Akola,20.746310479041902,77.12122320359276,501,1813906,932334,881572,1411281,6163,24232,308158,196077,504235,231841,328367,275264,291391,205723,112574,15157,1460317,352687,94.5553846582877,77.80342531531403
Maharashtra,Amravati,21.16520991810736,77.67583503184724,503,2888445,1480768,1407677,2251875,9438,36185,508921,272894,781815,326195,468853,463051,525116,346876,203273,16148,2349512,478074,95.0639803129187,77.96149831483721
Maharashtra,Bhandara,21.211792649727744,80.10950199637023,506,1200334,605520,594814,899860,2932,13165,283843,72575,356418,115150,187870,208902,204435,153749,67061,12452,949619,235524,98.23193288413265,74.9674673882436
Maharashtra,Chandrapur,20.095609090909072,79.31556380471388,509,2204307,1123834,1080473,1578615,8239,31419,451324,233331,684655,243773,316192,337320,351610,241179,126488,15040,1631602,516728,96.14168996488806,71.61502458595831
Maharashtra,Dhule,21.274018690400517,74.58719071837263,498,2050862,1054031,996831,1293916,6065,27139,382777,146013,528790,200494,323641,208571,290656,182739,114931,14526,1335558,649568,94.57321463979711,63.09132452597981
Maharashtra,Hingoli,19.59525302245251,77.09239412780653,512,1177345,606294,571051,790743,1221,9676,242456,41913,284369,175736,266649,127246,136075,74544,38698,5932,824880,331388,94.18714353102621,67.16323592489883
Maharashtra,Jalgaon,20.8828943415638,75.55140421810695,499,4229917,2197365,2032552,2891882,14297,56775,796223,373565,1169788,482462,735730,532587,627198,375643,229987,31008,3014615,1003050,92.49951646631305,68.36734621506758
Maharashtra,Jalna,19.984612534818933,75.98473607242339,514,1959046,1011473,947573,1195523,3791,17236,404746,98084,502830,271061,422207,218189,225331,120715,64060,9724,1331287,545980,93.68248089667249,61.02577479038267
Maharashtra,Kolhapur,16.44881301587301,74.12897150793648,530,3876001,1980658,1895343,2825845,22269,71879,796496,382818,1179314,321457,622362,487227,698604,395234,335413,40828,2901125,778000,95.69259306755634,72.90619894060914
Maharashtra,Latur,18.348687268993853,76.75812607802874,524,2454196,1273140,1181056,1650672,6217,29758,428616,157016,585632,268627,423711,296910,380344,224998,153256,18106,1765952,596213,92.76717407355044,67.25917571375717
Maharashtra,Nagpur,21.196556862745105,79.02166176470584,505,4653570,2384975,2268595,3673808,57964,135750,430844,877522,1308366,325084,666693,812381,790443,542228,493236,73475,3703540,601547,95.12028427970944,78.94601349071789
Maharashtra,Nanded,19.209316983017,77.6829048951049,511,3361292,1730075,1631217,2189425,7548,43055,591119,230563,821682,416869,691348,368723,416761,255650,156225,21729,2327305,884626,94.28591246044246,65.13641183211693
Maharashtra,Nandurbar,21.523175625248147,74.32638757443429,497,1648295,833170,815125,906509,2579,17047,333440,71572,405012,166664,218718,121404,160961,113019,58461,9248,848475,790613,97.83417549839768,54.99676938897466
Maharashtra,Nashik,20.266912871287147,74.03824168316828,516,6107187,3157186,2950001,4345366,45039,138887,904661,764271,1668932,544346,1038955,851714,830070,485052,373100,97219,4220456,1481778,93.43766886081465,71.15167752354725
Maharashtra,Osmanabad,18.19459456066944,75.9949557531381,525,1657576,861535,796041,1137810,3209,18183,367158,77832,444990,183972,300965,201646,260772,139479,96847,9913,1193594,440363,92.39798731334189,68.64300641418554
Maharashtra,Parbhani,19.31032425249168,76.70163338870431,513,1836086,942870,893216,1157814,3982,21196,293480,133759,427239,229217,396713,204316,229103,116041,81333,9703,1266426,552643,94.73373847932378,63.058810970727954
Maharashtra,Pune,18.51696171428573,74.12922881632646,521,9429408,4924105,4505303,7171723,235018,490260,1165718,2056739,3222457,559840,1234549,1383055,1414563,867256,1086650,190336,6736249,1353077,91.49486048733729,76.05698045943076
Maharashtra,Ratnagiri,17.210195070127703,73.25725893866405,528,1615069,761121,853948,1199392,7752,31062,538538,100824,639362,163025,378554,269872,247257,111600,65700,15429,1251437,319622,112.19608971503874,74.26258568519364
Maharashtra,Sangli,17.154930181086502,74.70713822937628,531,2822143,1435728,1386415,2049467,13212,49056,626872,226801,853673,208511,507318,459156,453404,244804,214003,36983,2124179,579039,96.56529649070019,72.62094798172878
Maharashtra,Satara,17.6737908974359,74.18052064102558,527,3003741,1510842,1492899,2225694,14093,57423,774522,200949,975471,288427,495822,407977,556706,299993,243457,20884,2313266,545423,98.81238408781329,74.09740054152472
Maharashtra,Sindhudurg,16.170948049777163,73.51329008172344,529,849651,417332,432319,666067,3517,15721,295847,44989,340836,86480,165284,134734,175070,89023,48418,3451,702460,121922,103.59114565861233,78.39301077736623
Maharashtra,Solapur,17.837357937584812,75.42394823609216,526,4317756,2227852,2089904,2910676,15145,59296,779929,376302,1156231,390337,788150,535848,643327,328020,236302,29051,2951035,976795,93.8080267450441,67.41177593175715
Maharashtra,Thane,19.698767747440268,72.79882742564581,517,11060148,5865078,5195070,8227161,256170,551643,713994,2904157,3618151,712171,1530916,1588196,1751284,1080597,961719,114453,7739336,1692022,88.57631560910187,74.38563209099914
Maharashtra,Wardha,20.80743024390242,78.57259105691062,504,1300774,668385,632389,1019458,4313,16260,268486,120218,388704,140470,186781,201471,225208,158055,93772,7017,1012774,212054,94.61448117477202,78.37318396585418
Maharashtra,Washim,20.282282394366213,77.25502394366208,502,1197160,620302,576858,869917,1875,10757,274925,55921,330846,166509,238985,160331,162762,116032,47865,7294,899778,291525,92.99631469832437,72.66505730228207
Maharashtra,Yavatmal,20.04258346738159,78.05326371760479,510,2772348,1419965,1352383,2022574,6094,29917,629243,168889,798132,391944,562739,382001,389924,245819,123074,21889,2117390,718204,95.24058691587469,72.9552711275785
Manipur,Bishnupur,24.507121118012428,93.8246236024845,275,237399,118782,118617,156333,676,3447,34977,21172,56149,15941,36011,50004,31775,20077,20074,1440,175322,67610,99.86109006415114,65.85242566312411
Manipur,Chandel,24.2635812987013,94.09443844155844,280,144182,74579,69603,90302,184,1782,30377,3783,34160,17382,28163,30589,18971,12213,8105,240,115663,38191,93.32788050255434,62.630564148090606
Manipur,Churachandpur,24.30309718875504,93.38671506024085,274,274143,138820,135323,195935,837,4496,52972,4853,57825,32860,67907,65475,38567,23284,14523,509,243125,57561,97.48091053162369,71.4718230996232
Manipur,Senapati,25.08465586034914,94.03366234413956,272,479148,247323,231825,264477,256,2170,38008,1826,39834,46757,81735,91395,62033,40438,24940,598,347896,191001,93.73370046457467,55.19735029677678
Manipur,Tamenglong,24.98312942238265,93.49450740072204,273,140651,72371,68280,85006,125,1362,23982,4119,28101,11155,28461,26794,17867,11645,7102,270,103294,45317,94.34718326401459,60.43753688206981
Manipur,Thoubal,24.54539255319149,93.97959893617023,276,422168,210845,211323,269304,880,5110,65961,38302,104263,32396,69738,87932,55803,37899,28550,3214,315532,118088,100.22670682254737,63.79071838699285
Manipur,Ukhrul,25.05900314960629,94.44129566929138,279,183998,94718,89280,129829,276,2437,36084,5806,41890,20670,29382,38350,31734,22729,15636,405,158906,42156,94.25874701746237,70.56000608702269
Meghalaya,East Garo Hills,25.82728228228228,90.64684924924916,294,317917,161223,156694,192147,288,2368,62698,11518,74216,51578,70679,52762,31328,9473,2484,298,218602,100781,97.1908474597297,60.439359958731366
Meghalaya,East Khasi Hills,25.303763888888888,91.75922519841272,298,825922,410749,415173,578030,5032,19306,106248,108843,215091,118135,163729,127722,94579,58836,61639,9397,634037,168575,101.07705679137379,69.98602773627533
Meghalaya,Jaintia Hills,25.33959557069844,92.376081601363,299,395124,196285,198839,187527,510,4333,76546,7171,83717,67749,61526,34677,26748,13544,8039,2934,215217,165184,101.30116921822861,47.46029094663954
Meghalaya,South Garo Hills,25.24056857855361,90.64560349127176,295,142334,73170,69164,82062,179,1625,35930,3713,39643,25906,28921,21506,13858,3998,826,831,95846,44849,94.52507858411917,57.654530892126964
Meghalaya,West Garo Hills,25.495285185185185,90.03709947089943,293,643291,324159,319132,358702,1630,8872,139351,18594,157945,85733,129178,90963,70941,29404,10856,3547,420622,208900,98.44921782211816,55.76045677617129
Meghalaya,West Khasi Hills,25.50088992673993,91.25364542124538,296,383461,193715,189746,230678,149,2462,74832,12299,87131,80318,78208,45046,28417,12295,6450,541,251275,133244,97.95111374958057,60.15683472373984
Mizoram,Aizawl,23.90781335453101,92.85359459459472,283,400309,199270,201039,340595,4019,21093,20570,80341,100911,29332,68214,100103,78752,37701,31310,2058,347470,38248,100.88774025191951,85.08302336445097
Mizoram,Champhai,23.541665809768663,93.24221799485862,284,125745,63388,62357,100802,186,2263,18395,12717,31112,14491,31359,30454,16259,4956,4087,78,101684,15449,98.37350918154856,80.16382361127678
Mizoram,Kolasib,24.2020004347826,92.73470391304348,282,83955,42918,41037,65895,367,1986,9669,12507,22176,11367,18046,20399,9849,3473,2530,62,65726,14217,95.61722354256955,78.48847596926926
Mizoram,Lawngtlai,22.36102843137253,92.66964156862753,287,117894,60599,57295,62861,162,1329,21993,5273,27266,19890,21114,16629,10538,3763,2515,125,74574,54874,94.5477648146009,53.31993146385736
Mizoram,Lunglei,23.007717036172675,92.63512555425892,286,161428,82891,78537,121122,482,3725,21479,17315,38794,22181,33313,34774,19918,8503,5509,116,124314,32451,94.74731876802065,75.03159303218773
Mizoram,Mamit,23.73852942502819,92.4330803833147,281,86364,44828,41536,60191,90,1073,16726,4129,20855,9328,19711,19949,10756,3180,1771,22,64717,20091,92.65637547961096,69.69454865453199
Mizoram,Saiha,22.35744801061008,93.02827931034489,288,56574,28594,27980,42233,168,1194,7043,5784,12827,8422,14151,12130,7269,3628,2204,69,47873,8787,97.85269636986781,74.650899706579
Mizoram,Serchhip,23.263864705882344,92.914158496732,285,64937,32851,32086,54476,131,987,7472,8018,15490,8771,14985,16237,9062,2915,2128,35,54133,5963,97.6713037654866,83.89054006190617
Nagaland,Dimapur,25.81417681159423,93.75074057971014,265,378811,197394,181417,278037,3303,12077,49116,62853,111969,34539,61815,80076,44343,26712,27532,2939,277956,58926,91.90603564444714,73.39728782955089
Nagaland,Kohima,25.603114285714284,93.78600657596373,270,267988,138966,129022,197489,1928,7982,31845,44255,76100,21654,46756,57726,30518,19855,23439,1770,201718,45802,92.84429284861045,73.69322506977925
Nagaland,Mokokchung,26.47891176470589,94.522426006192,262,194622,101092,93530,159494,537,2728,37536,17742,55278,20259,43483,54035,27425,13077,10299,870,169448,22555,92.51968503937007,81.95065306080505
Nagaland,Mon,26.692073743016763,95.03072988826828,261,250260,131753,118507,119626,178,2844,43607,7415,51022,37431,46055,30500,7628,3565,1772,107,127058,130529,89.94633898279356,47.80068728522337
Nagaland,Phek,25.632729865771815,94.56814563758392,266,163418,83743,79675,105893,170,1558,38903,7295,46198,22494,32722,30434,12785,7268,5926,481,112110,44456,95.14228054882199,64.79885936677722
Nagaland,Tuensang,26.21104453280316,94.85809880715708,267,196596,101933,94663,117511,155,2251,40690,9451,50141,29602,40900,33514,15013,6008,2760,116,127913,66450,92.86786418529819,59.77283362835459
Nagaland,Wokha,26.20261155115511,94.1990815181518,264,166343,84505,81838,128208,198,1757,38499,8170,46669,15865,37024,41627,18746,10223,8030,401,131916,25048,96.84397372936513,77.07447863751405
Nagaland,Zunheboto,26.028178205128214,94.50026666666668,263,140757,71217,69540,102881,261,2008,31267,6044,37311,16523,30889,35113,17282,8821,5560,1107,115295,25988,97.64522515691479,73.09121393607423
Punjab,Amritsar,31.54867982062777,74.79883856502238,49,2490656,1318408,1172248,1684770,29961,63864,275477,385476,660953,197944,313874,283819,328229,203656,142399,15879,1485800,540010,88.9139022214671,67.6436248120977
Punjab,Bathinda,30.190524611973352,75.05685898004437,46,1388525,743197,645328,844868,11284,32253,218159,137563,355722,117795,182796,145626,163928,96329,70240,16666,793380,438529,86.8313515797292,60.84643776669487
Punjab,Faridkot,30.591187250996025,74.79751553784862,45,617508,326671,290837,381285,4348,12276,99946,58917,158863,53734,89433,71178,75419,48360,29838,5790,373752,204895,89.03055367632878,61.745758759400694
Punjab,Fatehgarh Sahib,30.64290947368421,76.36208394736842,40,600163,320795,279368,426033,5138,14294,117559,57337,174896,51897,102257,83931,95073,59555,34990,4607,432310,142314,87.08614535762715,70.98621541147988
Punjab,Firozpur,30.63407535211269,74.40245732394365,43,2029074,1071637,957437,1227511,10042,31070,348522,153868,502390,196971,306838,226433,221806,147698,82448,25734,1207928,714869,89.3434063960091,60.49611793359927
Punjab,Gurdaspur,32.04283371212125,75.3204064393939,35,2298323,1212617,1085706,1634719,14428,38445,420860,185488,606348,180897,315156,290618,372317,243539,104345,22107,1528979,478020,89.53412330521509,71.12659969899792
Punjab,Hoshiarpur,31.551571698113197,75.8469857442349,38,1586625,809057,777568,1199699,13747,34328,422673,128592,551265,143871,256127,238975,301435,176013,93618,17427,1227466,294723,96.10793800684007,75.61326715512487
Punjab,Jalandhar,31.25033690721651,75.54400350515463,37,2193590,1145211,1048379,1622537,39082,79134,330339,377791,708130,183441,333736,304652,339758,216646,162965,34576,1575774,387809,91.54461492249027,73.96719532820627
Punjab,Kapurthala,31.33659263803684,75.47641165644177,36,815168,426311,388857,576567,9732,23145,165433,95770,261203,71698,127031,112774,128828,77442,48221,9501,575495,174995,91.21439512468596,70.72983728507498
Punjab,Ludhiana,30.76596397379912,75.83110851528383,41,3498739,1867816,1630923,2560225,58589,123400,395032,641789,1036821,277247,488129,443759,527568,318876,272280,44240,2372099,631980,87.31711260638093,73.17564985556224
Punjab,Mansa,29.919547714285727,75.4304922857143,47,769751,408732,361019,423560,2673,10085,145603,50786,196389,75708,106162,84553,85953,48663,27461,5658,434158,311513,88.32658074239355,55.025586196055606
Punjab,Moga,30.756540067340065,75.16008451178449,42,995746,525920,469826,627889,7897,21662,214295,74144,288439,98764,158812,116716,128693,85642,37417,11956,638000,306336,89.33411925768178,63.057145095235136
Punjab,Patiala,30.214540380693364,76.27505893949697,48,1895686,1002522,893164,1266791,24274,55105,299279,218090,517369,173890,283837,239609,256826,157435,141947,27272,1280816,518772,89.09171070560048,66.82493830729351
Punjab,Rupnagar,30.91093733075435,76.53743500967127,51,684627,357485,327142,502731,6600,17542,148162,60537,208699,53005,107715,98135,116836,68794,38823,9388,492696,124100,91.51209141642308,73.43137211941685
Punjab,Sangrur,30.18504520433689,75.89437014178496,53,1655169,878029,777140,1002077,10736,30955,292156,156788,448944,163251,250833,197901,220210,130155,73636,18393,1054379,570103,88.50960503582456,60.54227695177955
Rajasthan,Ajmer,26.199300378787907,74.6990419191919,119,2583052,1324085,1258967,1526673,13499,41732,409335,274919,684254,379043,394576,313680,200191,130608,172683,28138,1618919,1034334,95.08203778458332,59.10345591184382
Rajasthan,Alwar,27.55271738035265,76.65359630562563,104,3674179,1939026,1735153,2182476,9750,45770,782294,212967,995261,492781,492981,468628,324050,230415,222622,31390,2262867,1384905,89.4858036973202,59.40037216477477
Rajasthan,Banswara,23.45364203296701,74.44246868131869,125,1797485,907754,889731,829343,2324,15062,390437,39407,429844,240067,190259,137780,75011,50438,47094,8145,748794,1040914,98.01455019752048,46.13907765572453
Rajasthan,Baran,24.98023243243244,76.86210651828291,128,1222755,633945,588810,693307,1363,9491,249184,69804,318988,203489,194024,144190,76209,46847,49939,8057,722755,545842,92.88029718666446,56.70040196114512
Rajasthan,Barmer,25.77070908045978,71.50297126436782,115,2603751,1369022,1234729,1188322,2766,37730,542825,55980,598805,406804,352636,219932,101291,52272,39533,7328,1179796,1501858,90.1905886099712,45.63884949060029
Rajasthan,Bharatpur,27.32411858037578,77.21752077244258,105,2548462,1355726,1192736,1480869,4179,26106,479437,129697,609134,363676,330336,314953,211938,147520,132571,23311,1524305,1104824,87.97765920252323,58.108341423179944
Rajasthan,Bhilwara,25.45119767759564,74.63947595628417,122,2408523,1220736,1187787,1256126,6207,24014,530015,145865,675880,398993,338296,258990,141250,92785,106667,10928,1347909,1180456,97.3008906102548,52.15337366510513
Rajasthan,Bikaner,28.124890683229808,73.2694332298137,101,2363937,1240801,1123136,1278801,7607,29531,335754,196179,531933,410155,333211,254335,143669,80296,101714,18577,1341957,1015331,90.51701280060219,54.09623860534354
Rajasthan,Bundi,25.48580716049379,75.79984074074079,121,1110906,577160,533746,585044,1392,7705,239836,63452,303288,153500,159218,121104,63248,41227,41052,6460,585809,553622,92.47799570309793,52.66368171564471
Rajasthan,Churu,28.29330375536484,74.65846427038629,102,2039547,1051446,988101,1149269,2577,15259,344897,148996,493893,336671,302022,237220,161520,100677,77282,13320,1228712,910226,93.97543953755114,56.34922852966859
Rajasthan,Dausa,26.912348176291808,76.57342097264443,109,1634409,857787,776622,938051,1719,14539,361084,59610,420694,229035,235474,208537,135234,92559,90833,13764,1005436,681980,90.53786079761059,57.39389589753849
Rajasthan,Dungarpur,23.75104807692308,73.84765641025645,124,1388552,696532,692020,681591,1477,11742,322816,31547,354363,238847,175059,114245,60656,42887,39312,4834,675840,764563,99.35221928066478,49.086458411352254
Rajasthan,Hanumangarh,29.181335179153105,74.74632573289902,100,1774692,931184,843508,1034136,3360,16217,389059,108694,497753,239601,273441,219194,153628,104087,84185,14416,1088552,723454,90.58446021409303,58.271294399253506
Rajasthan,Jaipur,27.03345929018789,75.77117286012533,110,6626178,3468507,3157671,4300965,76565,182350,754841,977838,1732679,819004,875940,823570,659389,455527,703673,96562,4433665,2046038,91.03833436115309,64.90868491610095
Rajasthan,Jaisalmer,26.86900838548185,71.18371877346682,114,669919,361708,308211,308653,754,7416,159117,30830,189947,109484,71132,41264,20142,12759,10604,1720,267105,397649,85.20989306291263,46.07318198170226
Rajasthan,Jhalawar,24.24725541474657,76.11242891705066,129,1411129,725143,685986,739792,1750,9403,298624,63763,362387,226614,203488,143108,73388,46267,47985,6972,747822,696680,94.60009956656825,52.42554011716859
Rajasthan,Jodhpur,26.678460838536967,73.00450847457628,113,3687165,1923928,1763237,2031532,19335,54808,584215,307442,891657,497762,512035,405132,259304,154789,177199,30720,2036941,1591957,91.64776436540245,55.09739867893083
Rajasthan,Karauli,26.51901555555556,76.96081818181815,107,1458248,783639,674609,805849,1059,13045,305047,59308,364355,220644,193938,170399,104208,69443,67639,14402,840673,668926,86.08670574078116,55.26145072717398
Rajasthan,Kota,25.17571808000001,76.18618928000002,127,1951014,1021161,929853,1298345,12843,36297,203454,311735,515189,286676,294591,250092,172538,118710,167778,27485,1317870,588142,91.05841292411286,66.5471903328218
Rajasthan,Nagaur,27.078620160481464,74.14215667001012,112,3307743,1696325,1611418,1758624,4449,35328,675712,166489,842201,513871,486057,388822,242053,147701,117444,14853,1910801,1533137,94.99465019969641,53.16688751211929
Rajasthan,Pali,25.80490393541874,73.55285640766905,118,2037573,1025422,1012151,1085693,4043,19270,512909,139808,652717,293818,359329,271312,144581,71472,67021,9403,1216936,983050,98.70580112383,53.28363695435697
Rajasthan,Rajsamand,25.248947674418588,73.96570215946844,123,1156597,581339,575258,619139,1989,9222,304622,61054,365676,190090,190388,140839,72969,41063,34286,4732,674367,544517,98.95396661844465,53.53109164211908
Rajasthan,Sawai Madhopur,26.251081180223288,76.4219283891548,108,1335551,704031,631520,741748,1887,14310,282057,71264,353321,205450,172925,151108,87349,57625,70870,14384,759711,586492,89.70059557036551,55.53872521528568
Rajasthan,Sikar,27.646440586419764,75.29317422839503,111,2677333,1374990,1302343,1652117,5647,28382,527560,178274,705834,369959,438872,367412,282595,200430,181282,19321,1859871,967497,94.71654339304287,61.7075649536311
Rajasthan,Sirohi,24.7976905263158,72.75309131578945,117,1036346,534231,502115,476806,2146,10297,238535,69639,308174,117971,147381,110385,58213,30724,27076,5251,497001,577092,93.98836832755867,46.008379440843115
Rajasthan,Tonk,26.15393507170793,75.79192216427637,120,1421326,728136,693190,749659,1908,12482,298911,81755,380666,237191,190750,154825,91853,64431,67155,9919,816124,661902,95.20062186184998,52.743635168849366
Rajasthan,Udaipur,24.440767521367487,73.84029839743584,130,3068420,1566801,1501619,1582629,14211,48517,665449,182769,848218,442946,386075,277392,164290,102085,142672,20010,1535470,1528671,95.83980352322982,51.57797824287418
Tamil Nadu,Ariyalur,11.190514836795256,79.22249643916912,616,754894,374703,380191,480604,1749,8371,223955,30322,254277,60697,134123,113437,96860,53934,57524,16126,532701,233438,101.46462665097424,63.66509735141622
Tamil Nadu,Chennai,13.058098905608746,80.28139151846807,603,4646732,2335844,2310888,3776276,217368,355838,0,1314125,1314125,167207,516445,720331,801050,464207,905515,67277,3642032,419065,98.93160673401134,81.267350903818
Tamil Nadu,Coimbatore,10.871376995940452,77.0761901217862,632,3458045,1729297,1728748,2635907,63273,149920,284795,884957,1169752,220388,466745,523563,526165,273098,440520,53709,2504188,519919,99.9682529952923,76.22535276435094
Tamil Nadu,Cuddalore,11.57587300613498,79.63002365371497,617,2605914,1311697,1294217,1815281,15396,50938,497429,260780,758209,169844,412237,418769,386652,186394,227530,67411,1868837,634041,98.66737516362392,69.66005017817164
Tamil Nadu,Dharmapuri,12.300141200000004,78.11509813333339,630,1506843,774303,732540,917709,3651,18927,396819,91107,487926,129778,240222,221194,177877,103367,112592,26069,1011099,512824,94.60637502373102,60.902761601573616
Tamil Nadu,Dindigul,10.377801390820574,77.78011279554937,612,2159775,1080938,1078837,1481834,9155,38677,443818,269724,713542,207751,386421,372636,282628,153100,163050,29443,1595029,480681,99.80563177536547,68.61057286059891
Tamil Nadu,Erode,11.267012155963302,77.42034334862393,610,2251744,1129868,1121876,1492662,18604,58861,411286,432398,843684,175017,345914,319484,269016,155344,215514,30391,1510680,608003,99.29266073559036,66.28915187516876
Tamil Nadu,Karur,10.79532776617955,78.08749686847605,613,1064493,528184,536309,727044,4915,17995,212241,152420,364661,76629,190229,167466,146666,77874,85595,14951,759410,276930,101.53828968692729,68.29955669036809
Tamil Nadu,Madurai,9.904313833333331,78.0136603333333,623,3038252,1526475,1511777,2273430,34097,95311,417718,592723,1010441,234611,525151,532616,453509,250285,363152,39350,2398674,449125,99.03712802371477,74.82690705050142
Tamil Nadu,Nagapattinam,10.789468161718288,79.79437299431483,618,1616450,798127,818323,1213008,5585,19692,399016,118724,517740,136593,323359,313357,249630,122350,125639,35762,1306690,253572,102.53042435602353,75.0414797859507
Tamil Nadu,Namakkal,11.33766638477801,78.14624841437633,609,1726601,869280,857321,1176131,8960,31581,370357,257127,627484,123573,297179,247516,214836,126468,169206,21582,1200360,388418,98.62426375851278,68.11828557958671
Tamil Nadu,Perambalur,11.260137758112096,78.86034011799416,615,565223,282157,283066,375823,1507,7745,155413,33179,188592,85210,106751,85101,71650,41447,44025,9189,443373,109011,100.32216106635667,66.49110174214425
Tamil Nadu,Pudukkottai,10.130514816433578,79.05444484265728,621,1618345,803188,815157,1110545,4494,18272,399712,104229,503941,97231,283299,270046,251855,121706,111731,31315,1167183,447346,101.49018660637361,68.62226533897284
Tamil Nadu,Ramanathapuram,9.31286995153476,78.99185362412462,626,1353445,682658,670787,978946,5172,22379,290478,126761,417239,246909,293886,236511,189132,105978,97405,16785,1186606,107292,98.26106190801251,72.32994321897085
Tamil Nadu,Salem,11.629324202127654,78.2478257978723,608,3482056,1781571,1700485,2285562,20660,63867,572813,597539,1170352,188672,571061,518763,457866,242306,296399,60365,2335432,955045,95.44862371468777,65.63828956225862
Tamil Nadu,Sivaganga,9.960306580645158,78.56535729032254,622,1339101,668672,670429,959744,5773,24456,309224,143193,452417,101778,216931,236700,199263,103903,115894,23941,998410,311112,100.26275961906586,71.67077016595462
Tamil Nadu,Thanjavur,10.387692255892237,79.3194869107745,620,2405890,1182416,1223474,1790998,13495,42912,479070,274302,753372,138375,431983,419605,373111,178126,222410,49261,1812871,461123,103.47238197047402,74.44222304427883
Tamil Nadu,Theni,9.924066666666668,77.43458833333331,624,1245899,625683,620216,870080,4667,18830,189328,221295,410623,90590,219747,213496,156676,95231,101147,14674,891561,270738,99.12623485055532,69.83551636208072
Tamil Nadu,Tiruvannamalai,12.419318947368414,79.23265631578953,606,2464875,1235889,1228986,1626813,6445,27529,563102,147061,710163,203879,442688,423135,343955,174560,158041,36454,1782712,672427,99.44145469374676,65.9998174349612
Tamil Nadu,Vellore,12.78488263229308,79.02643283582084,605,3936331,1961688,1974643,2773928,20623,69912,653499,486801,1140300,191963,721473,719731,641585,311434,308514,71127,2965827,891430,100.66040063455554,70.46988680575896
Tamil Nadu,Virudhunagar,9.468872195892564,77.87641469194315,625,1942288,967709,974579,1398788,10219,37357,363782,370942,734724,163264,398670,317054,230321,138306,167506,35156,1450277,403246,100.70992416108562,72.01753807880192
Tripura,Dhalai,23.781360477941163,91.94654283088232,291,378230,194544,183686,276217,273,5067,89457,14071,103528,64515,84516,74015,21430,9157,6425,890,260948,109130,94.41874331770704,73.0288448827433
Tripura,North Tripura,24.121739755351683,92.17842538226292,292,693947,352860,341087,520402,997,10310,150437,42184,192621,129329,179547,158211,47160,22720,18419,3736,559122,156840,96.66354928300176,74.99160598720074
Tripura,South Tripura,23.211874098057383,91.6065807585568,290,876001,447544,428457,646810,948,10393,219171,44906,264077,129846,223185,204201,70173,31690,26870,5160,691125,188363,95.73516793879485,73.83667370242728
Tripura,West Tripura,23.780166241299334,91.41310788863107,289,1725739,879428,846311,1361354,6394,36186,289621,217016,506637,248343,421485,451563,156277,88122,85405,13478,1464673,279053,96.2342568123826,78.88527755355823
Uttar Pradesh,Agra,26.995129749103928,78.05278291517321,146,4418797,2364953,2053844,2680510,27183,82012,496971,406852,903823,600839,904836,647340,450571,317618,199395,20781,3141380,963202,86.8450239814491,60.66153299189803
Uttar Pradesh,Aligarh,27.937485768500927,78.00146831119557,143,3673889,1951996,1721893,2092567,13634,58336,582117,275942,858059,456870,491605,443958,334738,216997,172585,20498,2137251,1352181,88.21191231949246,56.957817723943215
Uttar Pradesh,Allahabad,25.392038662316445,82.05172446982063,175,5954391,3131807,2822584,3665727,24122,85491,983266,265304,1248570,823863,934881,738076,596615,502826,428871,36764,4061896,1756098,90.1263711333425,61.56342437035123
Uttar Pradesh,Ambedkar Nagar,26.39119025974028,82.68282142857147,178,2397888,1212410,1185478,1486939,2509,27308,501559,65031,566590,342667,392873,353570,247028,172872,194387,15458,1718855,813502,97.77863923920125,62.010360784156724
Uttar Pradesh,Auraiya,26.668923940149607,79.42637057356606,162,1379545,740040,639505,930836,2404,14279,255836,58438,314274,133123,291837,282449,168866,101542,79012,6531,1063360,276224,86.4149235176477,67.47413096346983
Uttar Pradesh,Azamgarh,26.00829095477384,83.01220251256285,191,4613913,2285004,2328909,2771917,6652,47324,891024,80434,971458,831966,1344726,879745,489060,312571,158303,8087,4024458,1218146,101.92144083774033,60.077357332051996
Uttar Pradesh,Baghpat,29.04579349999999,77.30266300000002,139,1303048,700070,602978,797970,2989,19999,246055,69991,316046,139646,272939,215070,132197,79475,44164,3730,887221,376700,86.13110117559673,61.23872643218055
Uttar Pradesh,Bahraich,27.69177630057803,81.46779783237004,180,3487731,1843884,1643847,1398368,2681,35463,698520,61742,760262,447648,493760,215939,104762,65106,47690,7028,1381933,1920966,89.15132405292306,40.09391779354543
Uttar Pradesh,Ballia,25.86075638297873,84.03651978723408,193,3239774,1672902,1566872,1963590,4672,42969,564927,64454,629381,436021,515010,443440,409484,323582,200434,20283,2348254,1032533,93.66191205462125,60.608857284489595
Uttar Pradesh,Balrampur,27.449076537911324,82.47158326180256,182,2148665,1114721,1033944,868357,1551,15510,410070,35768,445838,379253,227932,122911,65516,40633,37109,2777,876131,1332817,92.75361278741497,40.413791819571685
Uttar Pradesh,Banda,25.351885902503284,80.52487391304344,170,1799410,965876,833534,1002937,1655,18612,378056,67569,445625,325773,415195,249238,114783,61702,63112,5728,1235531,588025,86.29824118209791,55.73699156945888
Uttar Pradesh,Bara Banki,26.922777025232424,81.35762350597606,176,3260699,1707073,1553626,1692458,3159,26293,635840,79068,714908,533140,420824,350564,197780,132332,113799,12281,1760720,1540841,91.01110497324953,51.90476029832867
Uttar Pradesh,Bareilly,28.51101940789474,79.43187072368416,150,4448359,2357665,2090694,2191759,15164,56575,631613,362798,994411,717585,641251,442110,272840,172554,146446,16806,2409592,1744527,88.67646591012718,49.271180675840235
Uttar Pradesh,Basti,26.83388045454545,82.69790590909092,185,2464464,1255272,1209192,1393783,3423,30244,513960,31065,545025,470355,349221,324085,211477,162961,143642,13030,1674771,1021192,96.32908246180908,56.55521849781535
Uttar Pradesh,Bijnor,29.313974259681096,78.45098815489754,134,3682713,1921215,1761498,2135393,7303,37341,683875,224648,908523,498971,827447,549594,255028,159528,148185,14658,2453411,1308683,91.68666703101943,57.984236078130444
Uttar Pradesh,Bulandshahr,28.34875862068968,78.01082758620684,142,3499171,1845260,1653911,2031656,7865,38225,658449,221628,880077,443641,540754,475146,338138,217882,151182,17796,2184539,1185318,89.6302418087424,58.0610664640282
Uttar Pradesh,Chandauli,25.1180859611231,83.25307062634984,196,1952756,1017905,934851,1174606,3492,20762,344937,50822,395759,295979,367768,276638,196240,135962,88299,7586,1368472,543247,91.84069240253265,60.15119144429719
Uttar Pradesh,Chitrakoot,25.159924623803,81.07666087551297,171,991730,527721,464009,531072,827,9437,207237,23558,230795,168472,174106,124256,69641,40266,35826,3660,616227,383908,87.92695382598001,53.55005898782935
Uttar Pradesh,Deoria,26.42218856548857,83.82440706860709,190,3100946,1537436,1563510,1875239,4469,36068,597778,67928,665706,602403,473097,449571,372031,277548,194341,23334,2392325,1130108,101.6959405139466,60.47312658782191
Uttar Pradesh,Etah,27.591155309734443,78.70021858407083,201,1774480,947339,827141,1055202,2635,19712,334246,67752,401998,238019,214091,201984,178434,119665,88607,8092,1048892,718310,87.31203930166498,59.4654208556873
Uttar Pradesh,Etawah,26.78817670157068,79.07621806282728,161,1581810,845856,735954,1062003,2964,21506,265643,85483,351126,171216,292852,298700,195192,121283,118571,13400,1211214,397708,87.00700828509818,67.13846795759288
Uttar Pradesh,Faizabad,26.60589185185181,82.00783530864202,177,2470996,1259628,1211368,1450901,4746,28625,510378,79288,589666,356093,361114,347114,231129,176303,179996,18947,1670696,981915,96.1687101271169,58.71725409510983
Uttar Pradesh,Farrukhabad,27.45063297872342,79.44062845744679,159,1885204,1006240,878964,1092677,2624,18733,316647,94843,411490,270550,330084,257279,184298,115069,110391,9368,1277039,710960,87.35132771505803,57.96067693469779
Uttar Pradesh,Fatehpur,25.8374362030905,80.8541620309051,172,2632733,1384722,1248011,1512166,3385,33501,558807,77733,636540,409875,463642,376472,227119,134445,116445,10212,1738210,895178,90.12718798430298,57.437119525603244
Uttar Pradesh,Firozabad,27.20963993055552,78.42660624999998,147,2498156,1332046,1166110,1521806,5834,31797,349747,185621,535368,324525,416295,368905,277163,166249,108627,11313,1673077,672115,87.54277254689401,60.91717250644075
Uttar Pradesh,Gautam Buddha Nagar,28.393311038961038,77.52462467532466,141,1648115,890214,757901,1122947,53181,87188,170835,338935,509770,201277,330623,283031,218587,194796,101645,5058,1335017,342284,85.13694459983779,68.13523328165813
Uttar Pradesh,Ghaziabad,28.74997308584685,77.67441879350343,140,4681645,2488834,2192811,3123264,78116,179552,355407,836316,1191723,534606,858286,797473,597661,475439,255949,26399,3545813,885070,88.10595644386086,66.71296093573946
Uttar Pradesh,Ghazipur,25.624724775583488,83.5360854578097,195,3620268,1855075,1765193,2197549,5309,50180,700173,61467,761640,566504,691057,563310,449909,334003,186306,12795,2803884,1008996,95.15480506178996,60.70127957377741
Uttar Pradesh,Gonda,27.157215552099505,82.0226888024882,183,3433919,1787146,1646773,1679994,4313,31811,673578,52794,726372,678171,425584,305644,192664,144067,118176,8722,1873028,1620782,92.1454094964821,48.92351858037421
Uttar Pradesh,Gorakhpur,26.63315886792452,83.35495603773579,188,4440895,2277777,2163118,2700328,14597,65360,761958,189170,951128,873031,618398,560246,425913,316166,273903,36253,3103910,1453960,94.96618852503998,60.805941144746726
Uttar Pradesh,Hardoi,27.337409090909137,80.26411767676768,155,4092845,2191442,1901403,2221601,3845,32065,786613,121064,907677,741817,906861,510507,247265,138583,103523,9048,2657604,1481604,86.76492464778899,54.28011566526463
Uttar Pradesh,Jalaun,26.06795458715599,79.36686911314993,165,1689974,906092,783882,1075196,2217,18615,304856,91565,396421,169207,327534,282919,167911,104699,106888,10399,1169557,461666,86.51240712863594,63.622043889432625
Uttar Pradesh,Jaunpur,25.70141280913127,82.54315351934063,194,4494204,2220465,2273739,2731677,8002,52398,926088,80582,1006670,665376,939616,769693,520111,353996,256398,25909,3531099,1344789,102.39922718889962,60.782220833767234
Uttar Pradesh,Jhansi,25.45581535234902,78.89954580536917,166,1998603,1057436,941167,1304513,8517,40774,309592,195321,504913,184997,370685,341371,186348,99814,92586,11783,1287584,483088,89.00463006744617,65.27124196251081
Uttar Pradesh,Kannauj,26.993988617886185,79.64437940379408,160,1656616,881776,774840,1017087,2488,18082,299785,65985,365770,237853,283674,263749,175582,107628,95072,7194,1170752,543034,87.8726570013246,61.3954591770211
Uttar Pradesh,Kanpur Dehat,26.43047641196011,79.98710083056478,163,1796184,963255,832929,1170243,2682,25354,363933,41323,405256,235341,344866,341845,223529,157167,97740,5930,1406418,475166,86.47024931093013,65.15162143744739
Uttar Pradesh,Kaushambi,25.53587532051282,81.41811282051287,174,1599596,838485,761111,813424,1503,15029,349856,30764,380620,184229,253910,180825,146757,89011,45341,5115,905188,670750,90.77216646690161,50.851840089622634
Uttar Pradesh,Kushinagar,26.892530675909864,83.92261542461006,189,3564544,1818055,1746489,1954820,3486,35931,742324,42775,785099,836856,424892,367405,249265,170911,119625,11970,2180924,1550315,96.06359543578165,54.84067527291009
Uttar Pradesh,Lalitpur,24.58877161016945,78.60082330508473,167,1221592,641011,580581,641191,1079,9906,258013,43819,301832,185575,202692,154118,61543,32237,34658,3535,674358,509536,90.5727046805749,52.48814661523651
Uttar Pradesh,Lucknow,26.838233589251463,80.89706026871404,157,4589838,2394476,2195362,3127260,68506,152257,344155,717566,1061721,489898,554301,552171,428121,378742,639260,52132,3094625,1146880,91.68444369457033,68.13443088841044
Uttar Pradesh,Mahoba,25.34529670138888,79.67863003472216,169,875958,466358,409600,488106,1316,11298,198298,48525,246823,119002,141201,131165,60400,33810,37165,3926,526669,403649,87.82952152638101,55.72253464207188
Uttar Pradesh,Mainpuri,27.17386862302482,79.03501851015807,148,1868529,993377,875152,1203885,2642,24451,338475,72783,411258,234774,353287,319158,230731,144516,111696,12281,1406443,519493,88.09867754135641,64.42955929503904
Uttar Pradesh,Mathura,27.59390432801821,77.62153416856502,145,2547184,1367125,1180059,1507746,8726,37596,407488,177802,585290,303291,420976,344961,233264,155937,103102,10262,1571793,691359,86.31683276949803,59.19266138606398
Uttar Pradesh,Mau,26.01082203791469,83.50582654028433,192,2205968,1114709,1091259,1363044,2656,26716,352207,99321,451528,344570,410737,320743,256784,209493,150462,15771,1708560,659237,97.89631195226737,61.788928941852284
Uttar Pradesh,Meerut,29.029576256983237,77.80611005586594,138,3443689,1825743,1617946,2141488,23717,69473,381520,422303,803823,412280,495861,469403,359944,254337,275076,36096,2302997,990312,88.61849668874535,62.18587102377712
Uttar Pradesh,Mirzapur,25.10207959183675,82.60126628571429,199,2496970,1312302,1184668,1428683,4447,24518,465152,77963,543115,361642,421577,340261,232189,177109,140668,17680,1691126,868542,90.27403753099516,57.216666599919094
Uttar Pradesh,Moradabad,28.851770406189537,78.73580193423598,135,4772006,2503186,2268820,2263848,11690,61846,692398,355518,1047916,635957,725118,492338,296210,186311,186489,23372,2545795,2097292,90.63729183528511,47.44017505426439
Uttar Pradesh,Muzaffarnagar,29.470507977736567,77.64017847866424,133,4143512,2193434,1950078,2417339,10077,56149,673746,296104,969850,826387,780470,531913,281747,148770,98691,5608,2673586,1431537,88.90525085322831,58.34034027173084
Uttar Pradesh,Pilibhit,28.52024175035868,79.90103974175037,151,2031007,1072002,959005,1061095,2870,18097,371752,89638,461390,294135,281158,240057,117838,77602,66129,9713,1086632,977839,89.45925474019639,52.24477315932441
Uttar Pradesh,Pratapgarh,25.86484273170732,81.93530048780492,131,867848,437744,430104,401515,716,5961,209813,24269,234082,142397,111276,70969,35206,21854,19109,2137,402948,488621,98.25468767133302,46.26559028770015
Uttar Pradesh,Pratapgarh,25.86484273170732,81.93530048780492,173,3209141,1606085,1603056,1931559,5149,34400,711085,41701,752786,427626,558350,456752,332742,238011,197846,20047,2231374,1059636,99.81140475130519,60.18928429757371
Uttar Pradesh,Rae Bareli,26.25390284005979,81.22260463378181,158,3405559,1752542,1653017,1965843,5184,34788,705025,73393,778418,540661,538301,477689,270775,182823,153041,15662,2178952,1286726,94.32110614182142,57.72453215463306
Uttar Pradesh,Rampur,28.83244727272725,79.10977333333338,136,2335819,1223889,1111930,1043666,3847,25960,396775,143217,539992,278477,374898,171242,85117,51703,43839,3169,1008445,1235413,90.852193295307,44.68094488485623
Uttar Pradesh,Saharanpur,30.03381165217392,77.59905147826096,132,3466382,1834106,1632276,2077108,9699,38816,605082,284156,889238,474060,600668,431491,256510,163463,154153,10083,2090428,1279517,88.99572870924581,59.92149739988264
Uttar Pradesh,Sant Kabir Nagar,26.791596516393447,83.0387764344262,186,1715183,869656,845527,954949,2031,19729,324972,27179,352151,341757,290532,205875,129442,86528,63506,8882,1126522,683053,97.22545466253322,55.67621647369406
Uttar Pradesh,Shahjahanpur,27.991389350649328,79.8302275324675,152,3006538,1606403,1400135,1490930,3889,27533,520289,134714,655003,451571,476064,315873,158430,96308,87355,8885,1594486,1324615,87.15963553354918,49.589594410581206
Uttar Pradesh,Sitapur,27.50199596309111,80.85288881199547,154,4483992,2375264,2108728,2283733,3874,34609,827583,111319,938902,714304,656401,482220,221898,136383,127750,8775,2347731,2141696,88.77867891737507,50.93080005495103
Uttar Pradesh,Sonbhadra,24.46693268858798,83.06816324951639,200,1862559,971344,891215,985708,5149,25220,337048,91040,428088,306218,297226,212565,120822,82614,63846,9357,1092648,745126,91.75070829695761,52.92224300008751
Uttar Pradesh,Sultanpur,26.284638641975302,82.05710456790123,179,3797117,1914586,1882531,2239902,5956,44008,839737,49891,889628,460210,637015,526973,306046,188848,176414,15277,2310783,1118891,98.32574770733726,58.9895439092343
Uttar Pradesh,Unnao,26.63163990895297,80.636773292868,156,3108367,1630087,1478280,1773584,3476,28719,596317,121039,717356,501457,512965,415378,240024,136688,101934,7173,1915619,1130103,90.68718418096702,57.05838467594078
Uttar Pradesh,Varanasi,25.360570888888887,82.82529666666672,197,3676841,1921857,1754984,2403903,19214,57583,438935,316129,755064,467782,608174,557052,447926,351391,281652,34841,2748818,906367,91.31709591296334,65.37957447711229
West Bengal,Bankura,23.081280892857155,87.12640053571438,339,3596674,1838095,1758579,2232992,4273,34128,900515,90885,991400,450029,545200,686924,261478,143882,133465,20379,2241357,1417787,95.67399943963724,62.08491511880143
West Bengal,Birbhum,24.06389342723,87.65153089201887,334,3502404,1790920,1711484,2158447,5210,39636,831044,134565,965609,417769,661190,622372,245201,122865,115743,15205,2200345,1346802,95.5645143278315,61.62758493880204
West Bengal,Dakshin Dinajpur,25.342094363021435,88.69821679819614,331,1676276,857199,819077,1083685,2518,24318,390949,70077,461026,247675,323965,327064,135556,63286,52345,5190,1155081,534394,95.55272462987008,64.64836339600399
West Bengal,Jalpaiguri,26.62642031250004,89.04154375000005,328,3872846,1983064,1889782,2498780,9322,48818,798378,319426,1117804,455854,765613,814395,292056,150360,129393,18916,2626587,1203423,95.29606709617036,64.5205102397565
West Bengal,Kolkata,22.550581481481487,88.35276481481479,342,4496694,2356766,2139928,3588137,136618,252644,0,1308106,1308106,255171,597841,820902,555529,425245,691804,89701,3436193,410988,90.79934113102446,79.79500050481532
West Bengal,Maldah,25.080268025751053,88.17191684549357,332,3988845,2051541,1937304,2086432,5357,63525,830318,128678,958996,478902,629137,595551,238078,109719,92207,18330,2161924,1960034,94.43164918468605,52.30667022659442
West Bengal,Murshidabad,24.25950655391121,88.1681686046512,333,7103807,3627564,3476243,4055834,7951,79729,1501066,350899,1851965,837828,1428661,1210859,443254,230242,170051,25975,4346870,3031841,95.82857807608633,57.09380899565543
West Bengal,Nadia,23.56410971055088,88.58293034547151,336,5167600,2653768,2513832,3480555,12787,77210,1081381,468390,1549771,605490,1093403,1052487,412193,236828,209562,25491,3635454,1570127,94.72689398621131,67.35341357690223
West Bengal,Uttar Dinajpur,26.044619165196977,88.23595232216337,330,3007134,1551066,1456068,1489667,2883,31210,683981,94269,778250,402590,488047,422777,163106,73395,59457,12723,1622095,1431264,93.87530898104916,49.53776585945289
